AACTATGCATTGGGCCTAC -> ACTATGCATTGGGCCTACT
TAACTGCTAGGCATACGCA -> AACTGCTAGGCATACGCAC
ACTTACCTCGAGGCGGAGA -> CTTACCTCGAGGCGGAGAT
ATACGTTATCGGCACGTTA -> TACGTTATCGGCACGTTAG
CGGGAGGTGGAGCCGTTGA -> GGGAGGTGGAGCCGTTGAG
CGCTCCGGCAAAGATTCAC -> GCTCCGGCAAAGATTCACA
ATTTCATTCCCGTCTATGT -> TTTCATTCCCGTCTATGTT
CAGATGAACGCGATTTGCG -> AGATGAACGCGATTTGCGC
GTGCGCGGCTCTTGGAAGC -> TGCGCGGCTCTTGGAAGCG
CGTCTGTCAATCGGCCCCC -> GTCTGTCAATCGGCCCCCC
GCTGGCCTCCTCCCCTCTA -> CTGGCCTCCTCCCCTCTAT
CATCGCACCAACCTAAGGA -> ATCGCACCAACCTAAGGAC
CTAAGACGCACTTCTGAAT -> TAAGACGCACTTCTGAATC
TAATATAAGAGTTGAGTCG -> AATATAAGAGTTGAGTCGA
TTACGATAGGAGACGCTCC -> TACGATAGGAGACGCTCCG
TTGCTCGCTAGCGCATCCA -> TGCTCGCTAGCGCATCCAC
CCCAAATAGTCTTAGGGCG -> CCAAATAGTCTTAGGGCGA
TTACTACAACAGACCGCAC -> TACTACAACAGACCGCACC
AATTCTCTTCTTCTCCTAC -> ATTCTCTTCTTCTCCTACA
TCTAACTGCTAGGCATACG -> CTAACTGCTAGGCATACGC
TCCAATCGCTGTACACAGT -> CCAATCGCTGTACACAGTT
AAACACTAGGCACAATTTC -> AACACTAGGCACAATTTCA
GAAATTTTACCTAGCTAGC -> AAATTTTACCTAGCTAGCC
GGTGGAGCCGTTGAGACAC -> GTGGAGCCGTTGAGACACC
AGTACTCTTCCCCAAATAC -> GTACTCTTCCCCAAATACG
GCGCTACTCTCATCGGCCC -> CGCTACTCTCATCGGCCCT
CGAATTCTCTTCTTCTCCT -> GAATTCTCTTCTTCTCCTA
GAGGTGGAGCCGTTGAGAC -> AGGTGGAGCCGTTGAGACA
TGATCCTTCACCGTCGTCT -> GATCCTTCACCGTCGTCTG
ACGATTCTCTCGTGGTTCC -> CGATTCTCTCGTGGTTCCA,CGATTCTCTCGTGGTTCCA,CGATTCTCTCGTGGTTCCA
GACTTGTTGGGATTAAACA -> ACTTGTTGGGATTAAACAC
TATTCTAGTACTGCCAACT -> ATTCTAGTACTGCCAACTT
GCATTCATTATCGACGTGT -> CATTCATTATCGACGTGTA
TTCCCGTCTATGTTAGCCC -> TCCCGTCTATGTTAGCCCA
GATGAACGCGATTTGCGCA -> ATGAACGCGATTTGCGCAA
GCAGATGAACGCGATTTGC -> CAGATGAACGCGATTTGCG
AGTACTGCCAACTTTACGT -> GTACTGCCAACTTTACGTT
TCGAGCGAATTCTCTTCTT -> CGAGCGAATTCTCTTCTTC
TTTGGCTATGGTAATGTCC -> TTGGCTATGGTAATGTCCG
AGTAAGCAGCGCATTCATT -> GTAAGCAGCGCATTCATTA
TTTGATGGCGTTAAGCAGG -> TTGATGGCGTTAAGCAGGA
TACGTTATCGGCACGTTAG -> ACGTTATCGGCACGTTAGC
GAGGAGACTCTTGCTGCCG -> AGGAGACTCTTGCTGCCGA
TCATAATCTTACGCGGCAT -> CATAATCTTACGCGGCATT
GATTAAACACTAGGCACAA -> ATTAAACACTAGGCACAAT
GTAATTGGATTCTCGAAGC -> TAATTGGATTCTCGAAGCG
GTTTTGCTCGCTAGCGCAT -> TTTTGCTCGCTAGCGCATC
GAGCCGTTGAGACACCCAA -> AGCCGTTGAGACACCCAAA
AAGCACTAGTGACTGAGCA -> AGCACTAGTGACTGAGCAG
GCAGCGCTGCCCATGCTGG -> CAGCGCTGCCCATGCTGGG
TTAGGCACTGCTATAATTC -> TAGGCACTGCTATAATTCT
ATATGATTTCATTCCCGTC -> TATGATTTCATTCCCGTCT
TCGGCCCCCCATCGTGTCC -> CGGCCCCCCATCGTGTCCA
GGAAAACTAAATTGAAATG -> GAAAACTAAATTGAAATGG
CATTCATCGTGTTTTGCTC -> ATTCATCGTGTTTTGCTCG
ACCAACCTAAGGACCAATC -> CCAACCTAAGGACCAATCC
GCACAGCCAGTGAGCAGGT -> CACAGCCAGTGAGCAGGTT
AGGACACTTACCTCGAGGC -> GGACACTTACCTCGAGGCG
TTTCTGAAGCTCCTTTGGC -> TTCTGAAGCTCCTTTGGCT
CTGGCACTTCTAAGAATGA -> TGGCACTTCTAAGAATGAG
CCTAGCTAGCCGGTGAGAC -> CTAGCTAGCCGGTGAGACT
TTGGGCCTACTATCCCTCT -> TGGGCCTACTATCCCTCTG
GCTGACTCGAATAGTCGAT -> CTGACTCGAATAGTCGATA
ATTCATCGTGTTTTGCTCG -> TTCATCGTGTTTTGCTCGC
ACACAATGCGTCAGAGAGA -> CACAATGCGTCAGAGAGAG
CGAATAAATTGACCATCTA -> GAATAAATTGACCATCTAT
CTAGTGACTGAGCAGCGTG -> TAGTGACTGAGCAGCGTGC
GATTGTATGCCCTCCAGGA -> ATTGTATGCCCTCCAGGAG
CGTTATCGGCACGTTAGCC -> GTTATCGGCACGTTAGCCC
TACGAGATCGAGCGAATTC -> ACGAGATCGAGCGAATTCT
CTGGTATATGGAAAACTAA -> TGGTATATGGAAAACTAAA
ATGTCCGCTCCGGCAAACC -> TGTCCGCTCCGGCAAACCG
TTTCATGTGGGCTGGATTC -> TTCATGTGGGCTGGATTCC
GGCAAATACAAAGGAAACG -> GCAAATACAAAGGAAACGA
CAATCCTCACTGGTCCGCT -> AATCCTCACTGGTCCGCTT
ACGCTAACACCACCATAGC -> CGCTAACACCACCATAGCA
CATCCACAGGAGGAACCTG -> ATCCACAGGAGGAACCTGG
GGGGTGTCTCACGCAGTCT -> GGGTGTCTCACGCAGTCTG
CTACTGATAAAGCGGGCTG -> TACTGATAAAGCGGGCTGG
TGTATGCCCTCCAGGAGAC -> GTATGCCCTCCAGGAGACT
GAGGACACTTACCTCGAGG -> AGGACACTTACCTCGAGGC
GGTTCCAATAATGAGAACA -> GTTCCAATAATGAGAACAC
ACTGGTTTGCAACTATGCA -> CTGGTTTGCAACTATGCAT
ATCCTAGCGAGCTGTGCGC -> TCCTAGCGAGCTGTGCGCG
TCACGCAGTCTGCGATTGT -> CACGCAGTCTGCGATTGTA
AATCCGAAAGTGAGGATGA -> ATCCGAAAGTGAGGATGAC
ATTGGATTCTCGAAGCGAT -> TTGGATTCTCGAAGCGATC
TATTGTTAAATTGAGGTAT -> ATTGTTAAATTGAGGTATC
TAGGTTGAATCATAGCCTG -> AGGTTGAATCATAGCCTGT
TTGCCGCAAACAGACATCG -> TGCCGCAAACAGACATCGC
ATGGAAAACTAAATTGAAA -> TGGAAAACTAAATTGAAAT
GCCGAAAATAAACGTCGGA -> CCGAAAATAAACGTCGGAA
TTTGAGCTCATATTTTTAC -> TTGAGCTCATATTTTTACA
GCACAATTTCATGTGGGCT -> CACAATTTCATGTGGGCTG
CCGGCAAAAACCCGGCGGA -> CGGCAAAAACCCGGCGGAC
GGATCTGGAAATCTTCTGT -> GATCTGGAAATCTTCTGTG
GGCTAAGAATCCGTACAAT -> GCTAAGAATCCGTACAATC
CAGACATCGCCGAGGACAC -> AGACATCGCCGAGGACACT
CCCCATCGTGTCCAGAATA -> CCCATCGTGTCCAGAATAC
GACATCGCCGAGGACACTT -> ACATCGCCGAGGACACTTA
AGGAAACGATTCTCTCGTG -> GGAAACGATTCTCTCGTGG
TTCTGTGGGCGGCAGCAGC -> TCTGTGGGCGGCAGCAGCA
TGGAGCCGTTGAGACACCC -> GGAGCCGTTGAGACACCCA
TGATGGCGTTAAGCAGGAT -> GATGGCGTTAAGCAGGATT
ACTTCCATCAATGTCCGCT -> CTTCCATCAATGTCCGCTC
CACCCAAATAGTCTTAGGG -> ACCCAAATAGTCTTAGGGC
GTGAGGATGACTTAGCGAA -> TGAGGATGACTTAGCGAAT
AGCCCGGCATAGCTATGTT -> GCCCGGCATAGCTATGTTT
GAATCATAGCCTGTCTGTA -> AATCATAGCCTGTCTGTAC
GCTAGGCATACGCACAGCC -> CTAGGCATACGCACAGCCA
CGTACAATCCTTCCTGCAG -> GTACAATCCTTCCTGCAGC
TCGCTGATTCGGGCATCGC -> CGCTGATTCGGGCATCGCA
GGACCCGTACTTGATAACA -> GACCCGTACTTGATAACAC
AATTGAAAAGCACTAGTGA -> ATTGAAAAGCACTAGTGAC
TATCGGCACGTTAGCCCGG -> ATCGGCACGTTAGCCCGGC
GATCCGGACTTTGATGGCG -> ATCCGGACTTTGATGGCGT
TTCACCGTCGTCTGTCAAT -> TCACCGTCGTCTGTCAATC
GTTATCGGCACGTTAGCCC -> TTATCGGCACGTTAGCCCG
CGCATCCACTTTTGACATT -> GCATCCACTTTTGACATTG
ACTTCTAAGAATGAGCTTC -> CTTCTAAGAATGAGCTTCA
CTTGCTGCCGAAAATAAAC -> TTGCTGCCGAAAATAAACG
CTTACGAGATCGAGCGAAT -> TTACGAGATCGAGCGAATT
AGCGGGCTGGCCTCCTCCC -> GCGGGCTGGCCTCCTCCCC
GTATCAAGTTACCGAATAA -> TATCAAGTTACCGAATAAA
GACGCTCCGCATGAGTAAT -> ACGCTCCGCATGAGTAATA
CATAGCTATGTTTCGGGAC -> ATAGCTATGTTTCGGGACC
TCGTAAAAGCGGTCTGGCA -> CGTAAAAGCGGTCTGGCAC
ATCGTGTCCAGAATACCAT -> TCGTGTCCAGAATACCATA
AGAATGAGCTTCATCCTAG -> GAATGAGCTTCATCCTAGC
GCCAACTTTACGTTTCATA -> CCAACTTTACGTTTCATAT
TGTCCGCTCCGGCAAAGAT -> GTCCGCTCCGGCAAAGATT
ATGAACAACTGTCTGCTGA -> TGAACAACTGTCTGCTGAT
TTAGCGAATTGCCTAAATA -> TAGCGAATTGCCTAAATAG
ATCGAGCCGTCGATTGTCC -> TCGAGCCGTCGATTGTCCT
GACGATTCTCTCGTGGTTC -> ACGATTCTCTCGTGGTTCC
ATGTGGGCTGGATTCCCCC -> TGTGGGCTGGATTCCCCCG
TTCCATGGCCTTACTACAA -> TCCATGGCCTTACTACAAC
TCTAAGAATGAGCTTCATC -> CTAAGAATGAGCTTCATCC
AAGTATCAAGTTACCGAAT -> AGTATCAAGTTACCGAATA
AGGTAGTACCCCTATATTC -> GGTAGTACCCCTATATTCG
TCCCCGTAATTGGATTCTC -> CCCCGTAATTGGATTCTCG
AAACGAGTACTCTTCCCCA -> AACGAGTACTCTTCCCCAA
TCCTTTGGCTATGGTAATG -> CCTTTGGCTATGGTAATGT
TCCCCGCAAACGAGTACTC -> CCCCGCAAACGAGTACTCT
ATAAACGTCGGAACTTATC -> TAAACGTCGGAACTTATCA
TCCAGTATATGATTTCATT -> CCAGTATATGATTTCATTC
GAACTACACTTCCATCAAT -> AACTACACTTCCATCAATG
CGCCTTAGCGTTACGATAG -> GCCTTAGCGTTACGATAGG
ACTGGTCCGCTTTCAACCT -> CTGGTCCGCTTTCAACCTA
AGCAGGTTCGCTGATTCGG -> GCAGGTTCGCTGATTCGGG
CGCGTAATCCGAAAGTGAG -> GCGTAATCCGAAAGTGAGG
TGAGAACACAATGCGTCAG -> GAGAACACAATGCGTCAGA
CAACGCTAACACCACCATA -> AACGCTAACACCACCATAG
GAGTACTCTTCCCCAAATA -> AGTACTCTTCCCCAAATAC
TCATCGTGTTTTGCTCGCT -> CATCGTGTTTTGCTCGCTA
TTTGCAACTATGCATTGGG -> TTGCAACTATGCATTGGGC
AAAAGCGGTCTGGCACTTC -> AAAGCGGTCTGGCACTTCT
AAATGTCCGCTCCGGCAAA -> AATGTCCGCTCCGGCAAAA
ATTTGCGCAATAGGAGCCG -> TTTGCGCAATAGGAGCCGC
TAGCCCGGCATAGCTATGT -> AGCCCGGCATAGCTATGTT
GCTAGCGCATCCACTTTTG -> CTAGCGCATCCACTTTTGA
TCCGGCAAAAACCCGGCGG -> CCGGCAAAAACCCGGCGGA
AACACTATGTTCCCCGCAA -> ACACTATGTTCCCCGCAAA
GATGAAGATCCAATCGCTG -> ATGAAGATCCAATCGCTGT
GGACGATTCTCTCGTGGTT -> GACGATTCTCTCGTGGTTC
CGCTGATTCGGGCATCGCA -> GCTGATTCGGGCATCGCAC
GAGGTATCCGTCCCGCCCG -> AGGTATCCGTCCCGCCCGT
CCAACGCTAACACCACCAT -> CAACGCTAACACCACCATA
ATTATGGCCGTGACTCAAG -> TTATGGCCGTGACTCAAGT
GATTCTGCCCTGACCCAAT -> ATTCTGCCCTGACCCAATT
GCAACATCGAGCCGTCGAT -> CAACATCGAGCCGTCGATT
CATCTATTGTTAAATTGAG -> ATCTATTGTTAAATTGAGG
TCCGCTCCGGCAAATACAA -> CCGCTCCGGCAAATACAAA
AGCGACCTATTCTAGTACT -> GCGACCTATTCTAGTACTG
GTTCTTAAGTAGGAACTAC -> TTCTTAAGTAGGAACTACA
CGTCATCCCGCGTGATGGT -> GTCATCCCGCGTGATGGTC
CTGTACACAGTTCGCAGAT -> TGTACACAGTTCGCAGATG
ATTTTTCCACATTATGGCC -> TTTTTCCACATTATGGCCG
CGGCAAATACAAAGGAAAC -> GGCAAATACAAAGGAAACG
CTAAAGGCAAAGACCAGCG -> TAAAGGCAAAGACCAGCGC
TCTCTCGTGGTTCCACAAT -> CTCTCGTGGTTCCACAATG
CCGCGCTTTCTGAAGCTCC -> CGCGCTTTCTGAAGCTCCT
GTCTGCGATTGTATGCCCT -> TCTGCGATTGTATGCCCTC
GATTCTCTCGTGGTTCCAC -> ATTCTCTCGTGGTTCCACA
GATTCTCTCGTGGTTCCAA -> ATTCTCTCGTGGTTCCAAG,ATTCTCTCGTGGTTCCAAT
GACGCACTTCTGAATCCGC -> ACGCACTTCTGAATCCGCG
TCCAAACAACGGATCTGGA -> CCAAACAACGGATCTGGAA
GGCCCTACTGATAAAGCGG -> GCCCTACTGATAAAGCGGG
CTTCTTCTCCTACAATTCG -> TTCTTCTCCTACAATTCGA
GATTCTCTCGTGGTTCCAT -> ATTCTCTCGTGGTTCCATC
ATTTCGCGCTACTCTCATC -> TTTCGCGCTACTCTCATCG
CACATTATGGCCGTGACTC -> ACATTATGGCCGTGACTCA
GGCATTGTCCCTGAGATTC -> GCATTGTCCCTGAGATTCT
CAACTATGCATTGGGCCTA -> AACTATGCATTGGGCCTAC
TGTAAGTGTTAGGGGCTCC -> GTAAGTGTTAGGGGCTCCA
CTGCCGAGGAGACTCTTGC -> TGCCGAGGAGACTCTTGCT
CCATCCAAACAACGGATCT -> CATCCAAACAACGGATCTG
GGGCGGCAGCAGCATTCAT -> GGCGGCAGCAGCATTCATC
GTAACCGTTGTAAGTGTTA -> TAACCGTTGTAAGTGTTAG
CCACATTATGGCCGTGACT -> CACATTATGGCCGTGACTC
AGCCAGTGAGCAGGTTCGC -> GCCAGTGAGCAGGTTCGCT
GAGCGAATTCTCTTCTTCT -> AGCGAATTCTCTTCTTCTC
GAAAATAAACGTCGGAACT -> AAAATAAACGTCGGAACTT
GATGGTCCACTAGCTACAA -> ATGGTCCACTAGCTACAAC
GCAGCGTGCCGTTATGTAC -> CAGCGTGCCGTTATGTACG
AATAGCCATTTATTTTTCC -> ATAGCCATTTATTTTTCCA
CCACTAGCTACAACCGTCT -> CACTAGCTACAACCGTCTT
AAGACCAACGCTAACACCA -> AGACCAACGCTAACACCAC
ATCCGTACAATCCTTCCTG -> TCCGTACAATCCTTCCTGC
TATAATTCTAACTGCTAGG -> ATAATTCTAACTGCTAGGC
TTCTCTCGTGGTTCCAATA -> TCTCTCGTGGTTCCAATAA
CGCTCCGGCAAACCGCCGT -> GCTCCGGCAAACCGCCGTG
TATGATTTCATTCCCGTCT -> ATGATTTCATTCCCGTCTA
CGGACGATTCTCTCGTGGT -> GGACGATTCTCTCGTGGTT
CTTTTGACATTGCTTACGA -> TTTTGACATTGCTTACGAG
ACTTGTTGGGATTAAACAC -> CTTGTTGGGATTAAACACT
CCGTCTATGTTAGCCCAGT -> CGTCTATGTTAGCCCAGTT
ACACTTCCATCAATGTCCG -> CACTTCCATCAATGTCCGC
GCAAATACAAAGGAAACGA -> CAAATACAAAGGAAACGAT
ACTGATAAAGCGGGCTGGC -> CTGATAAAGCGGGCTGGCC
TCCAAGGTATAGTAAGCAG -> CCAAGGTATAGTAAGCAGC
GTATCCGTCCCGCCCGTGT -> TATCCGTCCCGCCCGTGTT
CGGATCTGGAAATCTTCTG -> GGATCTGGAAATCTTCTGT
CATGAGTAATATAAGAGTT -> ATGAGTAATATAAGAGTTG
TGGGCCTATAATACGTTAT -> GGGCCTATAATACGTTATC
ATCCCTCTGTTTATCCCCG -> TCCCTCTGTTTATCCCCGT
TATGTACGGCTAAGAATCC -> ATGTACGGCTAAGAATCCG
ACGATAGGAGACGCTCCGC -> CGATAGGAGACGCTCCGCA
GCGTTAAGCAGGATTTCGC -> CGTTAAGCAGGATTTCGCG
AAATTTTACCTAGCTAGCC -> AATTTTACCTAGCTAGCCG
GGCGGAGATAGCGTGACTT -> GCGGAGATAGCGTGACTTG
CCGTTATGTACGGCTAAGA -> CGTTATGTACGGCTAAGAA
CGCAGATGAACGCGATTTG -> GCAGATGAACGCGATTTGC
CAATCGCTGTACACAGTTC -> AATCGCTGTACACAGTTCG
ACCTGGGGATCGTAAAAGC -> CCTGGGGATCGTAAAAGCG
GCGAATTCTCTTCTTCTCC -> CGAATTCTCTTCTTCTCCT
TTAGGGCGAATCCAGTATA -> TAGGGCGAATCCAGTATAT
GCGCCCAACTAACCAGCTA -> CGCCCAACTAACCAGCTAC
GTCAATCGGCCCCCCATCG -> TCAATCGGCCCCCCATCGT
GATTTCATTCCCGTCTATG -> ATTTCATTCCCGTCTATGT
TTCTCTCGTGGTTCCAAGG -> TCTCTCGTGGTTCCAAGGT
CTACAACCGTCTTTGAGCT -> TACAACCGTCTTTGAGCTC
CATCCAAACAACGGATCTG -> ATCCAAACAACGGATCTGG
CCACAGGAGGAACCTGGGG -> CACAGGAGGAACCTGGGGA
TGAAAAGCACTAGTGACTG -> GAAAAGCACTAGTGACTGA
ATAAGAGTTGAGTCGAGGT -> TAAGAGTTGAGTCGAGGTA
TCCGCTCCGGCAAAAACCC -> CCGCTCCGGCAAAAACCCG
GGGAAATTTTACCTAGCTA -> GGAAATTTTACCTAGCTAG
TCTTAGGGCGAATCCAGTA -> CTTAGGGCGAATCCAGTAT
GCCCGGCATAGCTATGTTT -> CCCGGCATAGCTATGTTTC
AACTCGGTTTGGGCCTATA -> ACTCGGTTTGGGCCTATAA
TAAATAGCCATTTATTTTT -> AAATAGCCATTTATTTTTC
CCTCCAGGAGACTGGTTTG -> CTCCAGGAGACTGGTTTGC
AGCGAGCTGTGCGCGGCTC -> GCGAGCTGTGCGCGGCTCT
GGAACTACACTTCCATCAA -> GAACTACACTTCCATCAAT
ACCATAATGAGTCTATGGG -> CCATAATGAGTCTATGGGG
CTCCTACAATTCGAATGTC -> TCCTACAATTCGAATGTCC
GAATGAGCTTCATCCTAGC -> AATGAGCTTCATCCTAGCG
CTATAATACGTTATCGGCA -> TATAATACGTTATCGGCAC
TCTAGTACTGCCAACTTTA -> CTAGTACTGCCAACTTTAC
CGGTCTGGCACTTCTAAGA -> GGTCTGGCACTTCTAAGAA
TCTATTGCCGCAAACAGAC -> CTATTGCCGCAAACAGACA
CAATTGAAAAGCACTAGTG -> AATTGAAAAGCACTAGTGA
GTCCGCTCCGGCAAATACA -> TCCGCTCCGGCAAATACAA
TCTGCGATTGTATGCCCTC -> CTGCGATTGTATGCCCTCC
TGAGGATGACTTAGCGAAT -> GAGGATGACTTAGCGAATT
ACCGCACCGTTTGGGAAAT -> CCGCACCGTTTGGGAAATT
CAAGACCAACGCTAACACC -> AAGACCAACGCTAACACCA
GGGATTAAACACTAGGCAC -> GGATTAAACACTAGGCACA
TCAGTTAGGCACTGCTATA -> CAGTTAGGCACTGCTATAA
CCCCTATATTCGTCATCCC -> CCCTATATTCGTCATCCCG
GATAAAGCGGGCTGGCCTC -> ATAAAGCGGGCTGGCCTCC
AGACATCGCCGAGGACACT -> GACATCGCCGAGGACACTT
GTTCGCAGATGAACGCGAT -> TTCGCAGATGAACGCGATT
ATTATCGACGTGTAACCGT -> TTATCGACGTGTAACCGTT
AGCCTGTCTGTACCCCCAT -> GCCTGTCTGTACCCCCATG
ATTGTCCCTGAGATTCTGC -> TTGTCCCTGAGATTCTGCC
TCGTGCACCTAATGGCGAG -> CGTGCACCTAATGGCGAGT
TCGAATAGTCGATACTGCC -> CGAATAGTCGATACTGCCG
CTATGGTAATGTCCGCTCC -> TATGGTAATGTCCGCTCCG
GCTGATCGAATAGTACACT -> CTGATCGAATAGTACACTT
ACTCGGTTTGGGCCTATAA -> CTCGGTTTGGGCCTATAAT
CTCCGGCAAAAACCCGGCG -> TCCGGCAAAAACCCGGCGG
CACTTCCATGGCCTTACTA -> ACTTCCATGGCCTTACTAC
CGTACTTGATAACACTATG -> GTACTTGATAACACTATGT
TTTACCTAGCTAGCCGGTG -> TTACCTAGCTAGCCGGTGA
CAACGGATCTGGAAATCTT -> AACGGATCTGGAAATCTTC
TGCTTACGAGATCGAGCGA -> GCTTACGAGATCGAGCGAA
CCCGCGTGATGGTCCACTA -> CCGCGTGATGGTCCACTAG
GCCGCCTTAGCGTTACGAT -> CCGCCTTAGCGTTACGATA
AAGCAGGATTTCGCGCTAC -> AGCAGGATTTCGCGCTACT
TGACTTGTTGGGATTAAAC -> GACTTGTTGGGATTAAACA
GATAACACTATGTTCCCCG -> ATAACACTATGTTCCCCGC
AATGTCCGCTCCGGCAAAT -> ATGTCCGCTCCGGCAAATA
GCGATCCGATGAAGATCCA -> CGATCCGATGAAGATCCAA
AATGTCCGCTCCGGCAAAA -> ATGTCCGCTCCGGCAAAAA
AATGTCCGCTCCGGCAAAG -> ATGTCCGCTCCGGCAAAGA
TAACCGTTGTAAGTGTTAG -> AACCGTTGTAAGTGTTAGG
CAACCGTCTTTGAGCTCAT -> AACCGTCTTTGAGCTCATA
ACAGTTCGCAGATGAACGC -> CAGTTCGCAGATGAACGCG
TGTTAGGGGCTCCAAAGTC -> GTTAGGGGCTCCAAAGTCG
CCAAATAGTCTTAGGGCGA -> CAAATAGTCTTAGGGCGAA
CCTCTATTGCCGCAAACAG -> CTCTATTGCCGCAAACAGA
ATTGAAATGGATGTTATCG -> TTGAAATGGATGTTATCGC
TGACTCAAGTATCAAGTTA -> GACTCAAGTATCAAGTTAC
TAATGTCCGCTCCGGCAAA -> AATGTCCGCTCCGGCAAAT
CTGACTCGAATAGTCGATA -> TGACTCGAATAGTCGATAC
CTTCATCCTAGCGAGCTGT -> TTCATCCTAGCGAGCTGTG
TACAACAGACCGCACCGTT -> ACAACAGACCGCACCGTTT
GTTCGCTGATTCGGGCATC -> TTCGCTGATTCGGGCATCG
TCATCGGCCCTACTGATAA -> CATCGGCCCTACTGATAAA
CGAGTACGCGGGAGGTGGA -> GAGTACGCGGGAGGTGGAG
ACCGTCTTTGAGCTCATAT -> CCGTCTTTGAGCTCATATT
TCGTCATCCCGCGTGATGG -> CGTCATCCCGCGTGATGGT
AGTATATGATTTCATTCCC -> GTATATGATTTCATTCCCG
TAATTGGATTCTCGAAGCG -> AATTGGATTCTCGAAGCGA
GGCCTACTATCCCTCTGTT -> GCCTACTATCCCTCTGTTT
AGGCACAATTTCATGTGGG -> GGCACAATTTCATGTGGGC
AGTCTATGGGGTGTCTCAC -> GTCTATGGGGTGTCTCACG
GGCCTTACTACAACAGACC -> GCCTTACTACAACAGACCG
CCAATTGAAAAGCACTAGT -> CAATTGAAAAGCACTAGTG
AATTTTACCTAGCTAGCCG -> ATTTTACCTAGCTAGCCGG
GGACTTTGATGGCGTTAAG -> GACTTTGATGGCGTTAAGC
TATGTTCCCCGCAAACGAG -> ATGTTCCCCGCAAACGAGT
GTACTTGATAACACTATGT -> TACTTGATAACACTATGTT
CCTCGAGGCGGAGATAGCG -> CTCGAGGCGGAGATAGCGT
CTAAGGACCAATCCTCACT -> TAAGGACCAATCCTCACTG
ACGTGTAACCGTTGTAAGT -> CGTGTAACCGTTGTAAGTG
ATGAGTCTATGGGGTGTCT -> TGAGTCTATGGGGTGTCTC
CTTCCATCAATGTCCGCTC -> TTCCATCAATGTCCGCTCC
TACTGGTATATGGAAAACT -> ACTGGTATATGGAAAACTA
ATTGACCATCTATTGTTAA -> TTGACCATCTATTGTTAAA
TCCGCTCCGGCAAAGATTC -> CCGCTCCGGCAAAGATTCA
TGTCTGCTGATCGAATAGT -> GTCTGCTGATCGAATAGTA
TCCGTCCCGCCCGTGTTGG -> CCGTCCCGCCCGTGTTGGC
AAGACCAGCGCGTAATCCG -> AGACCAGCGCGTAATCCGA
TGGTTCCAATAATGAGAAC -> GGTTCCAATAATGAGAACA
ATAATGAGTCTATGGGGTG -> TAATGAGTCTATGGGGTGT
GGAGCCGCCTTAGCGTTAC -> GAGCCGCCTTAGCGTTACG
GCTAAGAATCCGTACAATC -> CTAAGAATCCGTACAATCC
AAAGATTCACACCGCGATT -> AAGATTCACACCGCGATTC
TACGTTTCATATCCTAAGA -> ACGTTTCATATCCTAAGAC
ACACCACCATAGCAACATC -> CACCACCATAGCAACATCG
TTCCCCGCAAACGAGTACT -> TCCCCGCAAACGAGTACTC
TTGAGCTCATATTTTTACA -> TGAGCTCATATTTTTACAC
CAATAGGAGCCGCCTTAGC -> AATAGGAGCCGCCTTAGCG
ACTATGCATTGGGCCTACT -> CTATGCATTGGGCCTACTA
GTATATGGAAAACTAAATT -> TATATGGAAAACTAAATTG
AGTAATATAAGAGTTGAGT -> GTAATATAAGAGTTGAGTC
CCAGTTGCATACTGGTATA -> CAGTTGCATACTGGTATAT
AATTGCCTAAATAGCCATT -> ATTGCCTAAATAGCCATTT
GCGCTTTCTGAAGCTCCTT -> CGCTTTCTGAAGCTCCTTT
CTAGCCGGTGAGACTACGA -> TAGCCGGTGAGACTACGAG
GCGGCATTGTCCCTGAGAT -> CGGCATTGTCCCTGAGATT
TTCTGAATCCGCGCTTTCT -> TCTGAATCCGCGCTTTCTG
CGCGCTTTCTGAAGCTCCT -> GCGCTTTCTGAAGCTCCTT
ACACTTACCTCGAGGCGGA -> CACTTACCTCGAGGCGGAG
TTCTCTCGTGGTTCCACAA -> TCTCTCGTGGTTCCACAAT
CGATAGGAGACGCTCCGCA -> GATAGGAGACGCTCCGCAT
ACATTATGGCCGTGACTCA -> CATTATGGCCGTGACTCAA
GAGATAGCGTGACTTGTTG -> AGATAGCGTGACTTGTTGG
CGACCTATTCTAGTACTGC -> GACCTATTCTAGTACTGCC
TCCTGCAGCGCTGCCCATG -> CCTGCAGCGCTGCCCATGC
TGCGTCAGAGAGAGCGCTA -> GCGTCAGAGAGAGCGCTAA
ACTAGTGACTGAGCAGCGT -> CTAGTGACTGAGCAGCGTG
AGCTATGTTTCGGGACCCG -> GCTATGTTTCGGGACCCGT
CTGATCGAATAGTACACTT -> TGATCGAATAGTACACTTC
CGGGACCCGTACTTGATAA -> GGGACCCGTACTTGATAAC
CATATCCTAAGACGCACTT -> ATATCCTAAGACGCACTTC
CTATGTTTCGGGACCCGTA -> TATGTTTCGGGACCCGTAC
TGTCCGCTCCGGCAAACCG -> GTCCGCTCCGGCAAACCGC
TCATCCACAGGAGGAACCT -> CATCCACAGGAGGAACCTG
TATCGACGTGTAACCGTTG -> ATCGACGTGTAACCGTTGT
GAAATGGATGTTATCGCAT -> AAATGGATGTTATCGCATC
AATCCTTCCTGCAGCGCTG -> ATCCTTCCTGCAGCGCTGC
GAATAAATTGACCATCTAT -> AATAAATTGACCATCTATT
GTACACAGTTCGCAGATGA -> TACACAGTTCGCAGATGAA
GCCATTTATTTTTCCACAT -> CCATTTATTTTTCCACATT
CGAAATGAACAACTGTCTG -> GAAATGAACAACTGTCTGC
AGCAGGATTTCGCGCTACT -> GCAGGATTTCGCGCTACTC
GCGGAGATAGCGTGACTTG -> CGGAGATAGCGTGACTTGT
CGTGCGAAATGAACAACTG -> GTGCGAAATGAACAACTGT
CAAAGACCAGCGCGTAATC -> AAAGACCAGCGCGTAATCC
TCTTCCCCAAATACGTGCG -> CTTCCCCAAATACGTGCGA
CCGAGGAGACTCTTGCTGC -> CGAGGAGACTCTTGCTGCC
ACAATTCGAATGTCCGCTC -> CAATTCGAATGTCCGCTCC
CCCGCAAACGAGTACTCTT -> CCGCAAACGAGTACTCTTC
CACAGCCAGTGAGCAGGTT -> ACAGCCAGTGAGCAGGTTC
TTGGGCCTATAATACGTTA -> TGGGCCTATAATACGTTAT
CGACGTGTAACCGTTGTAA -> GACGTGTAACCGTTGTAAG
GCGGACGATTCTCTCGTGG -> CGGACGATTCTCTCGTGGT
AACCCGGCGGACGATTCTC -> ACCCGGCGGACGATTCTCT
TTTGGGAAATTTTACCTAG -> TTGGGAAATTTTACCTAGC
GAACGCGATTTGCGCAATA -> AACGCGATTTGCGCAATAG
TTCTCGAAGCGATCCGATG -> TCTCGAAGCGATCCGATGA
TCGATACTGCCGAGTACGC -> CGATACTGCCGAGTACGCG
GACCAATCCTCACTGGTCC -> ACCAATCCTCACTGGTCCG
CCTCCCCTCTATTGCCGCA -> CTCCCCTCTATTGCCGCAA
ATATTCGTCATCCCGCGTG -> TATTCGTCATCCCGCGTGA
GGGACCCGTACTTGATAAC -> GGACCCGTACTTGATAACA
TTTCAACCTAAGCGACCTA -> TTCAACCTAAGCGACCTAT
TGAGCTCATATTTTTACAC -> GAGCTCATATTTTTACACG
GAGTTGAGTCGAGGTAGTA -> AGTTGAGTCGAGGTAGTAC
CCTATATTCGTCATCCCGC -> CTATATTCGTCATCCCGCG
ACTGCCAACTTTACGTTTC -> CTGCCAACTTTACGTTTCA
AGCAGCGCATTCATTATCG -> GCAGCGCATTCATTATCGA
CTCCGGCAAAGATTCACAC -> TCCGGCAAAGATTCACACC
CGCGATTCTCTCGTGGTTC -> GCGATTCTCTCGTGGTTCC
GGGATCGTAAAAGCGGTCT -> GGATCGTAAAAGCGGTCTG
TTCCAATAATGAGAACACA -> TCCAATAATGAGAACACAA
CTAGCGCATCCACTTTTGA -> TAGCGCATCCACTTTTGAC
ATCTTCTGTGGGCGGCAGC -> TCTTCTGTGGGCGGCAGCA
CCGGCAAATACAAAGGAAA -> CGGCAAATACAAAGGAAAC
TTCGGGCATCGCACCAACC -> TCGGGCATCGCACCAACCT
ATTGTCCTTCATCCACAGG -> TTGTCCTTCATCCACAGGA
CTCATCGGCCCTACTGATA -> TCATCGGCCCTACTGATAA
GTTCCAATAATGAGAACAC -> TTCCAATAATGAGAACACA
TCTTCTCCTACAATTCGAA -> CTTCTCCTACAATTCGAAT
TATGGTAATGTCCGCTCCG -> ATGGTAATGTCCGCTCCGG
TGTTTCGGGACCCGTACTT -> GTTTCGGGACCCGTACTTG
TGGCACTTCTAAGAATGAG -> GGCACTTCTAAGAATGAGC
GGCCGTGACTCAAGTATCA -> GCCGTGACTCAAGTATCAA
GTTGCATACTGGTATATGG -> TTGCATACTGGTATATGGA
GTCCGCTTTCAACCTAAGC -> TCCGCTTTCAACCTAAGCG
GCAAAGATTCACACCGCGA -> CAAAGATTCACACCGCGAT
CGCTAACACCACCATAGCA -> GCTAACACCACCATAGCAA
CCCTACTGATAAAGCGGGC -> CCTACTGATAAAGCGGGCT
TTTACGTTTCATATCCTAA -> TTACGTTTCATATCCTAAG
GATGTTATCGCATCAGTTA -> ATGTTATCGCATCAGTTAG
TTATCGGCACGTTAGCCCG -> TATCGGCACGTTAGCCCGG
TTGATGGCGTTAAGCAGGA -> TGATGGCGTTAAGCAGGAT
GCATTGGGCCTACTATCCC -> CATTGGGCCTACTATCCCT
GCTCCTTTGGCTATGGTAA -> CTCCTTTGGCTATGGTAAT
TGGAAATCTTCTGTGGGCG -> GGAAATCTTCTGTGGGCGG
TGTCCTTCATCCACAGGAG -> GTCCTTCATCCACAGGAGG
CGAGTACTCTTCCCCAAAT -> GAGTACTCTTCCCCAAATA
GGCGGACGATTCTCTCGTG -> GCGGACGATTCTCTCGTGG
GAAGATCCAATCGCTGTAC -> AAGATCCAATCGCTGTACA
CCGTTGTAAGTGTTAGGGG -> CGTTGTAAGTGTTAGGGGC
AAGTAGGAACTACACTTCC -> AGTAGGAACTACACTTCCA
AGTGACTGAGCAGCGTGCC -> GTGACTGAGCAGCGTGCCG
AGACGCACTTCTGAATCCG -> GACGCACTTCTGAATCCGC
GAGATTCTGCCCTGACCCA -> AGATTCTGCCCTGACCCAA
GAATTGCCTAAATAGCCAT -> AATTGCCTAAATAGCCATT
GCAGTCTGCGATTGTATGC -> CAGTCTGCGATTGTATGCC
TACTTGATAACACTATGTT -> ACTTGATAACACTATGTTC
TGGTAGGTTGAATCATAGC -> GGTAGGTTGAATCATAGCC
GTCTTTGAGCTCATATTTT -> TCTTTGAGCTCATATTTTT
CTGAAGCTCCTTTGGCTAT -> TGAAGCTCCTTTGGCTATG
CTGCCGAGTACGCGGGAGG -> TGCCGAGTACGCGGGAGGT
TTGTATGCCCTCCAGGAGA -> TGTATGCCCTCCAGGAGAC
CGGGCTGGCCTCCTCCCCT -> GGGCTGGCCTCCTCCCCTC
AGCGCATCCACTTTTGACA -> GCGCATCCACTTTTGACAT
CCAATAATGAGAACACAAT -> CAATAATGAGAACACAATG
GTCTATGTTAGCCCAGTTG -> TCTATGTTAGCCCAGTTGC
AACCGTTGTAAGTGTTAGG -> ACCGTTGTAAGTGTTAGGG
GATTCCCCCGGGCAAGACC -> ATTCCCCCGGGCAAGACCA
GTACACTTCCATGGCCTTA -> TACACTTCCATGGCCTTAC
AGCCGCCTTAGCGTTACGA -> GCCGCCTTAGCGTTACGAT
AGGCGGAGATAGCGTGACT -> GGCGGAGATAGCGTGACTT
TCTGGCACTTCTAAGAATG -> CTGGCACTTCTAAGAATGA
TTACCTAGCTAGCCGGTGA -> TACCTAGCTAGCCGGTGAG
GATCCAATCGCTGTACACA -> ATCCAATCGCTGTACACAG
TCGTGGTTCCAATAATGAG -> CGTGGTTCCAATAATGAGA
CGCCGTGAAACGATTCTCT -> GCCGTGAAACGATTCTCTC
CCCGGCGGACGATTCTCTC -> CCGGCGGACGATTCTCTCG
ACCATAGCAACATCGAGCC -> CCATAGCAACATCGAGCCG
CAATGGTAGGTTGAATCAT -> AATGGTAGGTTGAATCATA
CCGAAAATAAACGTCGGAA -> CGAAAATAAACGTCGGAAC
TCCACAGGAGGAACCTGGG -> CCACAGGAGGAACCTGGGG
CTCTCGTGGTTCCACAATG -> TCTCGTGGTTCCACAATGG
CTGTCTGCTGATCGAATAG -> TGTCTGCTGATCGAATAGT
CGAGCTGTGCGCGGCTCTT -> GAGCTGTGCGCGGCTCTTG
CCCGGGCAAGACCAACGCT -> CCGGGCAAGACCAACGCTA
TGTCCGCTCCGGCAAAAAC -> GTCCGCTCCGGCAAAAACC
TGGCCGTGACTCAAGTATC -> GGCCGTGACTCAAGTATCA
CCCGTCTATGTTAGCCCAG -> CCGTCTATGTTAGCCCAGT
GCATCAGTTAGGCACTGCT -> CATCAGTTAGGCACTGCTA
GAGACACCCAAATAGTCTT -> AGACACCCAAATAGTCTTA
GTGGGCGGCAGCAGCATTC -> TGGGCGGCAGCAGCATTCA
CGCATCAGTTAGGCACTGC -> GCATCAGTTAGGCACTGCT
TGGGATTAAACACTAGGCA -> GGGATTAAACACTAGGCAC
ATTGCTTACGAGATCGAGC -> TTGCTTACGAGATCGAGCG
CTATTCTAGTACTGCCAAC -> TATTCTAGTACTGCCAACT
AGAGAGAGCGCTAAGTCCT -> GAGAGAGCGCTAAGTCCTG
GCACCGTTTGGGAAATTTT -> CACCGTTTGGGAAATTTTA
GATTTCGCGCTACTCTCAT -> ATTTCGCGCTACTCTCATC
ATGCATTGGGCCTACTATC -> TGCATTGGGCCTACTATCC
TCCGGACTTTGATGGCGTT -> CCGGACTTTGATGGCGTTA
ATCCGATGAAGATCCAATC -> TCCGATGAAGATCCAATCG
CCGTACAATCCTTCCTGCA -> CGTACAATCCTTCCTGCAG
TCAAGTATCAAGTTACCGA -> CAAGTATCAAGTTACCGAA
ATCAAGTTACCGAATAAAT -> TCAAGTTACCGAATAAATT
ACGCACAGCCAGTGAGCAG -> CGCACAGCCAGTGAGCAGG
TGTCAATCGGCCCCCCATC -> GTCAATCGGCCCCCCATCG
TAATCTTACGCGGCATTGT -> AATCTTACGCGGCATTGTC
CCAAATACGTGCGAAATGA -> CAAATACGTGCGAAATGAA
CCAAACAACGGATCTGGAA -> CAAACAACGGATCTGGAAA
TTCGCAGATGAACGCGATT -> TCGCAGATGAACGCGATTT
GCATACGCACAGCCAGTGA -> CATACGCACAGCCAGTGAG
TGGCTATGGTAATGTCCGC -> GGCTATGGTAATGTCCGCT
ACGCGGGAGGTGGAGCCGT -> CGCGGGAGGTGGAGCCGTT
GACCTATTCTAGTACTGCC -> ACCTATTCTAGTACTGCCA
CAACTGTCTGCTGATCGAA -> AACTGTCTGCTGATCGAAT
TTCTAAGAATGAGCTTCAT -> TCTAAGAATGAGCTTCATC
TCGAATAGTACACTTCCAT -> CGAATAGTACACTTCCATG
ATCCTAAGACGCACTTCTG -> TCCTAAGACGCACTTCTGA
CGCATGAGTAATATAAGAG -> GCATGAGTAATATAAGAGT
AATCCTCACTGGTCCGCTT -> ATCCTCACTGGTCCGCTTT
GCACTAGTGACTGAGCAGC -> CACTAGTGACTGAGCAGCG
CCAGAATACCATAATGAGT -> CAGAATACCATAATGAGTC
GTGGTTCCACAATGGTAGG -> TGGTTCCACAATGGTAGGT
TTATTTTTCCACATTATGG -> TATTTTTCCACATTATGGC
ATTCGAATGTCCGCTCCGG -> TTCGAATGTCCGCTCCGGC
CAGCGCATTCATTATCGAC -> AGCGCATTCATTATCGACG
AACTGTCTGCTGATCGAAT -> ACTGTCTGCTGATCGAATA
GCTACCTAAAGGCAAAGAC -> CTACCTAAAGGCAAAGACC
CCCTCCAGGAGACTGGTTT -> CCTCCAGGAGACTGGTTTG
CAGTCTGCGATTGTATGCC -> AGTCTGCGATTGTATGCCC
GAATTCTCTTCTTCTCCTA -> AATTCTCTTCTTCTCCTAC
GTGAAACGATTCTCTCGTG -> TGAAACGATTCTCTCGTGG
CGCAAACGAGTACTCTTCC -> GCAAACGAGTACTCTTCCC
GCGTGAAATTACAAATGTC -> CGTGAAATTACAAATGTCC
AGCGAATTCTCTTCTTCTC -> GCGAATTCTCTTCTTCTCC
CGGCATAGCTATGTTTCGG -> GGCATAGCTATGTTTCGGG
CGCAATAGGAGCCGCCTTA -> GCAATAGGAGCCGCCTTAG
TGGGGTGTCTCACGCAGTC -> GGGGTGTCTCACGCAGTCT
ACGAGTACTCTTCCCCAAA -> CGAGTACTCTTCCCCAAAT
ATGCCCTCCAGGAGACTGG -> TGCCCTCCAGGAGACTGGT
CGTCAGAGAGAGCGCTAAG -> GTCAGAGAGAGCGCTAAGT
ATACTGGTATATGGAAAAC -> TACTGGTATATGGAAAACT
GAGAAAAGCAATTTGCGGT -> AGAAAAGCAATTTGCGGTT
GCAGGTTCGCTGATTCGGG -> CAGGTTCGCTGATTCGGGC
GCGTCAGAGAGAGCGCTAA -> CGTCAGAGAGAGCGCTAAG
AGTTGAGTCGAGGTAGTAC -> GTTGAGTCGAGGTAGTACC
TCTATGGGGTGTCTCACGC -> CTATGGGGTGTCTCACGCA
TCCGATGAAGATCCAATCG -> CCGATGAAGATCCAATCGC
CCTAAGACGCACTTCTGAA -> CTAAGACGCACTTCTGAAT
ATCGTGTTTTGCTCGCTAG -> TCGTGTTTTGCTCGCTAGC
AGAACACAATGCGTCAGAG -> GAACACAATGCGTCAGAGA
ATGTTAGCCCAGTTGCATA -> TGTTAGCCCAGTTGCATAC
CCGCGATTCTCTCGTGGTT -> CGCGATTCTCTCGTGGTTC
ATGATTTCATTCCCGTCTA -> TGATTTCATTCCCGTCTAT
TATAGTAAGCAGCGCATTC -> ATAGTAAGCAGCGCATTCA
TAGGCATACGCACAGCCAG -> AGGCATACGCACAGCCAGT
CCGAAAGTGAGGATGACTT -> CGAAAGTGAGGATGACTTA
GCCCGTGTTGGCAAGCTGA -> CCCGTGTTGGCAAGCTGAC
AGCGCATTCATTATCGACG -> GCGCATTCATTATCGACGT
AAATTGAGGTATCCGTCCC -> AATTGAGGTATCCGTCCCG
CATCGCCGAGGACACTTAC -> ATCGCCGAGGACACTTACC
TAATGGCGAGTCTGGATCC -> AATGGCGAGTCTGGATCCG
TAAGAGTTGAGTCGAGGTA -> AAGAGTTGAGTCGAGGTAG
TACGCGGCATTGTCCCTGA -> ACGCGGCATTGTCCCTGAG
GGTATATGGAAAACTAAAT -> GTATATGGAAAACTAAATT
GCGCTAAGTCCTGCCGAGG -> CGCTAAGTCCTGCCGAGGA
TCCATGGCCTTACTACAAC -> CCATGGCCTTACTACAACA
AGCTAGCCGGTGAGACTAC -> GCTAGCCGGTGAGACTACG
GGCTATGGTAATGTCCGCT -> GCTATGGTAATGTCCGCTC
GCGAATCCAGTATATGATT -> CGAATCCAGTATATGATTT
CTGCTAGGCATACGCACAG -> TGCTAGGCATACGCACAGC
CAATGTCCGCTCCGGCAAA -> AATGTCCGCTCCGGCAAAC
TAGTCTTAGGGCGAATCCA -> AGTCTTAGGGCGAATCCAG
ATCCACTTTTGACATTGCT -> TCCACTTTTGACATTGCTT
CCGAGTACGCGGGAGGTGG -> CGAGTACGCGGGAGGTGGA
AGCAGCGTGCCGTTATGTA -> GCAGCGTGCCGTTATGTAC
GTCAGAGAGAGCGCTAAGT -> TCAGAGAGAGCGCTAAGTC
GCTGCCCATGCTGGGCGTG -> CTGCCCATGCTGGGCGTGA
TTGGGAAATTTTACCTAGC -> TGGGAAATTTTACCTAGCT
GTCCACTAGCTACAACCGT -> TCCACTAGCTACAACCGTC
AAATACGTGCGAAATGAAC -> AATACGTGCGAAATGAACA
ACGTTAGCCCGGCATAGCT -> CGTTAGCCCGGCATAGCTA
TTGGCTATGGTAATGTCCG -> TGGCTATGGTAATGTCCGC
GACTCTTGCTGCCGAAAAT -> ACTCTTGCTGCCGAAAATA
TATAAGAGTTGAGTCGAGG -> ATAAGAGTTGAGTCGAGGT
GAATGTCCGCTCCGGCAAA -> AATGTCCGCTCCGGCAAAG
CTAGGCACAATTTCATGTG -> TAGGCACAATTTCATGTGG
TCCTACAATTCGAATGTCC -> CCTACAATTCGAATGTCCG
AGCCGTCGATTGTCCTTCA -> GCCGTCGATTGTCCTTCAT
GCCCAGTTGCATACTGGTA -> CCCAGTTGCATACTGGTAT
TTATGTACGGCTAAGAATC -> TATGTACGGCTAAGAATCC
TCAAGTTACCGAATAAATT -> CAAGTTACCGAATAAATTG
GCGGTCTGGCACTTCTAAG -> CGGTCTGGCACTTCTAAGA
AGAATCCGTACAATCCTTC -> GAATCCGTACAATCCTTCC
TACAATTCGAATGTCCGCT -> ACAATTCGAATGTCCGCTC
ATTGGGCCTACTATCCCTC -> TTGGGCCTACTATCCCTCT
TTTTGACATTGCTTACGAG -> TTTGACATTGCTTACGAGA
CAAACAACGGATCTGGAAA -> AAACAACGGATCTGGAAAT
GGGCTGGCCTCCTCCCCTC -> GGCTGGCCTCCTCCCCTCT
TGAAATGGATGTTATCGCA -> GAAATGGATGTTATCGCAT
ACTATGTTCCCCGCAAACG -> CTATGTTCCCCGCAAACGA
TTCGCGCTACTCTCATCGG -> TCGCGCTACTCTCATCGGC
ATGAAGATCCAATCGCTGT -> TGAAGATCCAATCGCTGTA
AGAATACCATAATGAGTCT -> GAATACCATAATGAGTCTA
GAGACTGGTTTGCAACTAT -> AGACTGGTTTGCAACTATG
TAAGTCCTGCCGAGGAGAC -> AAGTCCTGCCGAGGAGACT
AGGAACCTGGGGATCGTAA -> GGAACCTGGGGATCGTAAA
CGTGGTTCCATCCAAACAA -> GTGGTTCCATCCAAACAAC
AACGGATCTGGAAATCTTC -> ACGGATCTGGAAATCTTCT
AGTTGCATACTGGTATATG -> GTTGCATACTGGTATATGG
CATCGTGTTTTGCTCGCTA -> ATCGTGTTTTGCTCGCTAG
GGTTCCACAATGGTAGGTT -> GTTCCACAATGGTAGGTTG
CGCGCTACTCTCATCGGCC -> GCGCTACTCTCATCGGCCC
CCCTATATTCGTCATCCCG -> CCTATATTCGTCATCCCGC
CTCGTGGTTCCATCCAAAC -> TCGTGGTTCCATCCAAACA
GAGCCGTCGATTGTCCTTC -> AGCCGTCGATTGTCCTTCA
CTGCCCTGACCCAATTGAA -> TGCCCTGACCCAATTGAAA
AAGCAGCGCATTCATTATC -> AGCAGCGCATTCATTATCG
ATCAATGTCCGCTCCGGCA -> TCAATGTCCGCTCCGGCAA
TGCTGCCGAAAATAAACGT -> GCTGCCGAAAATAAACGTC
CCTCTGTTTATCCCCGTAA -> CTCTGTTTATCCCCGTAAT
GAGCTGTGCGCGGCTCTTG -> AGCTGTGCGCGGCTCTTGG
TACGAGAAAAGCAATTTGC -> ACGAGAAAAGCAATTTGCG
TTACGAGATCGAGCGAATT -> TACGAGATCGAGCGAATTC
ATGGCCGTGACTCAAGTAT -> TGGCCGTGACTCAAGTATC
TGCCCATGCTGGGCGTGAA -> GCCCATGCTGGGCGTGAAA
TAGGCACAATTTCATGTGG -> AGGCACAATTTCATGTGGG
GTGAGACTACGAGAAAAGC -> TGAGACTACGAGAAAAGCA
AACTACACTTCCATCAATG -> ACTACACTTCCATCAATGT
AGCCGTTGAGACACCCAAA -> GCCGTTGAGACACCCAAAT
AGTATCAAGTTACCGAATA -> GTATCAAGTTACCGAATAA
GTACAATCCTTCCTGCAGC -> TACAATCCTTCCTGCAGCG
CCCGTGTTGGCAAGCTGAC -> CCGTGTTGGCAAGCTGACT
TGCTCGCTAGCGCATCCAC -> GCTCGCTAGCGCATCCACT
CCTTCCTGCAGCGCTGCCC -> CTTCCTGCAGCGCTGCCCA
GGCTCTTGGAAGCGCCCAA -> GCTCTTGGAAGCGCCCAAC
AGCGTGACTTGTTGGGATT -> GCGTGACTTGTTGGGATTA
CATCCCGCGTGATGGTCCA -> ATCCCGCGTGATGGTCCAC
TTGTTGGGATTAAACACTA -> TGTTGGGATTAAACACTAG
TTGCGCAATAGGAGCCGCC -> TGCGCAATAGGAGCCGCCT
AACCGCCGTGAAACGATTC -> ACCGCCGTGAAACGATTCT
AGTCCTGCCGAGGAGACTC -> GTCCTGCCGAGGAGACTCT
CCACTTTTGACATTGCTTA -> CACTTTTGACATTGCTTAC
AAACTCGGTTTGGGCCTAT -> AACTCGGTTTGGGCCTATA
AGGTATAGTAAGCAGCGCA -> GGTATAGTAAGCAGCGCAT
TGCTGGGCGTGAAATTACA -> GCTGGGCGTGAAATTACAA
AGCGCCCAACTAACCAGCT -> GCGCCCAACTAACCAGCTA
TCTGTCAATCGGCCCCCCA -> CTGTCAATCGGCCCCCCAT
ACCCAATTGAAAAGCACTA -> CCCAATTGAAAAGCACTAG
ATTCATTATCGACGTGTAA -> TTCATTATCGACGTGTAAC
TTACAAATGTCCGCTCCGG -> TACAAATGTCCGCTCCGGC
GTCCGCTCCGGCAAACCGC -> TCCGCTCCGGCAAACCGCC
ACATTGCTTACGAGATCGA -> CATTGCTTACGAGATCGAG
CCCTGACCCAATTGAAAAG -> CCTGACCCAATTGAAAAGC
AAACGATTCTCTCGTGGTT -> AACGATTCTCTCGTGGTTC,AACGATTCTCTCGTGGTTC
ATTCCCCCGGGCAAGACCA -> TTCCCCCGGGCAAGACCAA
TGGGAAATTTTACCTAGCT -> GGGAAATTTTACCTAGCTA
CCTAAAGGCAAAGACCAGC -> CTAAAGGCAAAGACCAGCG
TCTTACGCGGCATTGTCCC -> CTTACGCGGCATTGTCCCT
ACTTGATAACACTATGTTC -> CTTGATAACACTATGTTCC
CGTGTCCAGAATACCATAA -> GTGTCCAGAATACCATAAT
TCTGCCCTGACCCAATTGA -> CTGCCCTGACCCAATTGAA
ACTACGAGAAAAGCAATTT -> CTACGAGAAAAGCAATTTG
CGTAATCCGAAAGTGAGGA -> GTAATCCGAAAGTGAGGAT
TTCATCGTGTTTTGCTCGC -> TCATCGTGTTTTGCTCGCT
TCTGTTTATCCCCGTAATT -> CTGTTTATCCCCGTAATTG
GATCGAGCGAATTCTCTTC -> ATCGAGCGAATTCTCTTCT
TACCGAATAAATTGACCAT -> ACCGAATAAATTGACCATC
ATCATAGCCTGTCTGTACC -> TCATAGCCTGTCTGTACCC
CGGCCCTACTGATAAAGCG -> GGCCCTACTGATAAAGCGG
CGCGATTTGCGCAATAGGA -> GCGATTTGCGCAATAGGAG
TCCTTCCTGCAGCGCTGCC -> CCTTCCTGCAGCGCTGCCC
GTTAGCCCGGCATAGCTAT -> TTAGCCCGGCATAGCTATG
AGGACCAATCCTCACTGGT -> GGACCAATCCTCACTGGTC
TCCAGGAGACTGGTTTGCA -> CCAGGAGACTGGTTTGCAA
ACAGACATCGCCGAGGACA -> CAGACATCGCCGAGGACAC
TACTATCCCTCTGTTTATC -> ACTATCCCTCTGTTTATCC
GAATCCAGTATATGATTTC -> AATCCAGTATATGATTTCA
GTCCTTCATCCACAGGAGG -> TCCTTCATCCACAGGAGGA
GCCTTAGCGTTACGATAGG -> CCTTAGCGTTACGATAGGA
ACCGAATAAATTGACCATC -> CCGAATAAATTGACCATCT
GGCACTTCTAAGAATGAGC -> GCACTTCTAAGAATGAGCT
AGCGCTAAGTCCTGCCGAG -> GCGCTAAGTCCTGCCGAGG
TCTCGTGGTTCCACAATGG -> CTCGTGGTTCCACAATGGT
TCCGCATGAGTAATATAAG -> CCGCATGAGTAATATAAGA
TCTCGAAGCGATCCGATGA -> CTCGAAGCGATCCGATGAA
TGTCCCTGAGATTCTGCCC -> GTCCCTGAGATTCTGCCCT
TCCCTGAGATTCTGCCCTG -> CCCTGAGATTCTGCCCTGA
CTGATAAAGCGGGCTGGCC -> TGATAAAGCGGGCTGGCCT
GGATTTCGCGCTACTCTCA -> GATTTCGCGCTACTCTCAT
GCGCATTCATTATCGACGT -> CGCATTCATTATCGACGTG
TTCTAACTGCTAGGCATAC -> TCTAACTGCTAGGCATACG
AATCTTACGCGGCATTGTC -> ATCTTACGCGGCATTGTCC
TGAGTCTATGGGGTGTCTC -> GAGTCTATGGGGTGTCTCA
ATGGCCTTACTACAACAGA -> TGGCCTTACTACAACAGAC
GGCTGGATTCCCCCGGGCA -> GCTGGATTCCCCCGGGCAA
CTACCTAAAGGCAAAGACC -> TACCTAAAGGCAAAGACCA
TCATGTGGGCTGGATTCCC -> CATGTGGGCTGGATTCCCC
ACCTAAAGGCAAAGACCAG -> CCTAAAGGCAAAGACCAGC
CAAACAGACATCGCCGAGG -> AAACAGACATCGCCGAGGA
CAGCGCTGCCCATGCTGGG -> AGCGCTGCCCATGCTGGGC
CACTAGCTACAACCGTCTT -> ACTAGCTACAACCGTCTTT
ATACAAAGGAAACGATTCT -> TACAAAGGAAACGATTCTC
GTGACTTGTTGGGATTAAA -> TGACTTGTTGGGATTAAAC
GCTTCATCCTAGCGAGCTG -> CTTCATCCTAGCGAGCTGT
CGTGGTTCCAAGGTATAGT -> GTGGTTCCAAGGTATAGTA
GCCTATAATACGTTATCGG -> CCTATAATACGTTATCGGC
TGATAAAGCGGGCTGGCCT -> GATAAAGCGGGCTGGCCTC
CGTTGAGACACCCAAATAG -> GTTGAGACACCCAAATAGT
CTAACACCACCATAGCAAC -> TAACACCACCATAGCAACA
AAGCTGACTCGAATAGTCG -> AGCTGACTCGAATAGTCGA
CTCCGGCAAATACAAAGGA -> TCCGGCAAATACAAAGGAA
GCAAACAGACATCGCCGAG -> CAAACAGACATCGCCGAGG
TAAACGTCGGAACTTATCA -> AAACGTCGGAACTTATCAT
TCGAATGTCCGCTCCGGCA -> CGAATGTCCGCTCCGGCAA
ATGAGCTTCATCCTAGCGA -> TGAGCTTCATCCTAGCGAG
GGTAGGTTGAATCATAGCC -> GTAGGTTGAATCATAGCCT
CCACAATGGTAGGTTGAAT -> CACAATGGTAGGTTGAATC
GGGCCTACTATCCCTCTGT -> GGCCTACTATCCCTCTGTT
TATGGCCGTGACTCAAGTA -> ATGGCCGTGACTCAAGTAT
CCAACTAACCAGCTACCTA -> CAACTAACCAGCTACCTAA
CAACCTAAGGACCAATCCT -> AACCTAAGGACCAATCCTC
GGTTCGCTGATTCGGGCAT -> GTTCGCTGATTCGGGCATC
CAATTTGCGGTTCTTAAGT -> AATTTGCGGTTCTTAAGTA
CGGGCAAGACCAACGCTAA -> GGGCAAGACCAACGCTAAC
GACCATCTATTGTTAAATT -> ACCATCTATTGTTAAATTG
ATCGCATCAGTTAGGCACT -> TCGCATCAGTTAGGCACTG
TTGCTGCCGAAAATAAACG -> TGCTGCCGAAAATAAACGT
ACTGGTATATGGAAAACTA -> CTGGTATATGGAAAACTAA
AGCTGTGCGCGGCTCTTGG -> GCTGTGCGCGGCTCTTGGA
TTCGAATGTCCGCTCCGGC -> TCGAATGTCCGCTCCGGCA
GGCAAACCGCCGTGAAACG -> GCAAACCGCCGTGAAACGA
TCTCTCGTGGTTCCATCCA -> CTCTCGTGGTTCCATCCAA
AATAAATTGACCATCTATT -> ATAAATTGACCATCTATTG
GTAATGTCCGCTCCGGCAA -> TAATGTCCGCTCCGGCAAA
CATCCTAGCGAGCTGTGCG -> ATCCTAGCGAGCTGTGCGC
CCCCTCTATTGCCGCAAAC -> CCCTCTATTGCCGCAAACA
TGCCAACTTTACGTTTCAT -> GCCAACTTTACGTTTCATA
AGATAGCGTGACTTGTTGG -> GATAGCGTGACTTGTTGGG
ATCCAGTATATGATTTCAT -> TCCAGTATATGATTTCATT
ACGTCGGAACTTATCATAA -> CGTCGGAACTTATCATAAT
AAAACCCGGCGGACGATTC -> AAACCCGGCGGACGATTCT
GTTAAATTGAGGTATCCGT -> TTAAATTGAGGTATCCGTC
AATCCAGTATATGATTTCA -> ATCCAGTATATGATTTCAT
GCTCCAAAGTCGTGCACCT -> CTCCAAAGTCGTGCACCTA
CTCTTCTTCTCCTACAATT -> TCTTCTTCTCCTACAATTC
ACCTCGAGGCGGAGATAGC -> CCTCGAGGCGGAGATAGCG
CTTGGAAGCGCCCAACTAA -> TTGGAAGCGCCCAACTAAC
CTCCTTTGGCTATGGTAAT -> TCCTTTGGCTATGGTAATG
CCATGGCCTTACTACAACA -> CATGGCCTTACTACAACAG
ATTGAGGTATCCGTCCCGC -> TTGAGGTATCCGTCCCGCC
CGTGCCGTTATGTACGGCT -> GTGCCGTTATGTACGGCTA
GGAGACTGGTTTGCAACTA -> GAGACTGGTTTGCAACTAT
CTTAAGTAGGAACTACACT -> TTAAGTAGGAACTACACTT
AGCCCAGTTGCATACTGGT -> GCCCAGTTGCATACTGGTA
ACTTCTGAATCCGCGCTTT -> CTTCTGAATCCGCGCTTTC
GCGAAATGAACAACTGTCT -> CGAAATGAACAACTGTCTG
GCCTAAATAGCCATTTATT -> CCTAAATAGCCATTTATTT
GCCCTACTGATAAAGCGGG -> CCCTACTGATAAAGCGGGC
CGCAAACAGACATCGCCGA -> GCAAACAGACATCGCCGAG
TCGCCGAGGACACTTACCT -> CGCCGAGGACACTTACCTC
AACCGTCTTTGAGCTCATA -> ACCGTCTTTGAGCTCATAT
GCCTACTATCCCTCTGTTT -> CCTACTATCCCTCTGTTTA
GCAAAGACCAGCGCGTAAT -> CAAAGACCAGCGCGTAATC
TTCATGTGGGCTGGATTCC -> TCATGTGGGCTGGATTCCC
ACTTCCATGGCCTTACTAC -> CTTCCATGGCCTTACTACA
GTCGTGCACCTAATGGCGA -> TCGTGCACCTAATGGCGAG
TACCTAGCTAGCCGGTGAG -> ACCTAGCTAGCCGGTGAGA
CTACAACAGACCGCACCGT -> TACAACAGACCGCACCGTT
CTAAGAATGAGCTTCATCC -> TAAGAATGAGCTTCATCCT
CGTCCCGCCCGTGTTGGCA -> GTCCCGCCCGTGTTGGCAA
TTGTCCCTGAGATTCTGCC -> TGTCCCTGAGATTCTGCCC
CTCCGCATGAGTAATATAA -> TCCGCATGAGTAATATAAG
CACTAGTGACTGAGCAGCG -> ACTAGTGACTGAGCAGCGT
TTTGCGGTTCTTAAGTAGG -> TTGCGGTTCTTAAGTAGGA
TACGATAGGAGACGCTCCG -> ACGATAGGAGACGCTCCGC
GTCTATGGGGTGTCTCACG -> TCTATGGGGTGTCTCACGC
CTCTCATCGGCCCTACTGA -> TCTCATCGGCCCTACTGAT
GGCTGGCCTCCTCCCCTCT -> GCTGGCCTCCTCCCCTCTA
GAACACAATGCGTCAGAGA -> AACACAATGCGTCAGAGAG
TCTCGTGGTTCCAAGGTAT -> CTCGTGGTTCCAAGGTATA
TGCTAGGCATACGCACAGC -> GCTAGGCATACGCACAGCC
TATATTCGTCATCCCGCGT -> ATATTCGTCATCCCGCGTG
CCTGACCCAATTGAAAAGC -> CTGACCCAATTGAAAAGCA
TGAAGCTCCTTTGGCTATG -> GAAGCTCCTTTGGCTATGG
GCATCCACTTTTGACATTG -> CATCCACTTTTGACATTGC
ACGTTTCATATCCTAAGAC -> CGTTTCATATCCTAAGACG
CTTCTGTGGGCGGCAGCAG -> TTCTGTGGGCGGCAGCAGC
GTATAGTAAGCAGCGCATT -> TATAGTAAGCAGCGCATTC
GGGTGTCTCACGCAGTCTG -> GGTGTCTCACGCAGTCTGC
GCAGCAGCATTCATCGTGT -> CAGCAGCATTCATCGTGTT
CTCCAGGAGACTGGTTTGC -> TCCAGGAGACTGGTTTGCA
AACTAACCAGCTACCTAAA -> ACTAACCAGCTACCTAAAG
CCGCTCCGGCAAACCGCCG -> CGCTCCGGCAAACCGCCGT
ATCTATTGTTAAATTGAGG -> TCTATTGTTAAATTGAGGT
ACGTTATCGGCACGTTAGC -> CGTTATCGGCACGTTAGCC
ACTTATCATAATCTTACGC -> CTTATCATAATCTTACGCG
GTGTCCAGAATACCATAAT -> TGTCCAGAATACCATAATG
ATCCCGCGTGATGGTCCAC -> TCCCGCGTGATGGTCCACT
CTAAGTCCTGCCGAGGAGA -> TAAGTCCTGCCGAGGAGAC
GCCGCAAACAGACATCGCC -> CCGCAAACAGACATCGCCG
TCCCCCGGGCAAGACCAAC -> CCCCCGGGCAAGACCAACG
TGGCGTTAAGCAGGATTTC -> GGCGTTAAGCAGGATTTCG
AATCTTCTGTGGGCGGCAG -> ATCTTCTGTGGGCGGCAGC
GAGTACGCGGGAGGTGGAG -> AGTACGCGGGAGGTGGAGC
AAATACAAAGGAAACGATT -> AATACAAAGGAAACGATTC
ATCAGTTAGGCACTGCTAT -> TCAGTTAGGCACTGCTATA
CTTGATAACACTATGTTCC -> TTGATAACACTATGTTCCC
TGATTTCATTCCCGTCTAT -> GATTTCATTCCCGTCTATG
CTAAGCGACCTATTCTAGT -> TAAGCGACCTATTCTAGTA
AGCACTAGTGACTGAGCAG -> GCACTAGTGACTGAGCAGC
CTTTCTGAAGCTCCTTTGG -> TTTCTGAAGCTCCTTTGGC
CCATAGCAACATCGAGCCG -> CATAGCAACATCGAGCCGT
GGCGTGAAATTACAAATGT -> GCGTGAAATTACAAATGTC
ATTACAAATGTCCGCTCCG -> TTACAAATGTCCGCTCCGG
CGAGATCGAGCGAATTCTC -> GAGATCGAGCGAATTCTCT
GTCTGGATCCGGACTTTGA -> TCTGGATCCGGACTTTGAT
GAGACGCTCCGCATGAGTA -> AGACGCTCCGCATGAGTAA
GAGCTTCATCCTAGCGAGC -> AGCTTCATCCTAGCGAGCT
CGGCAAAAACCCGGCGGAC -> GGCAAAAACCCGGCGGACG
CAAATGTCCGCTCCGGCAA -> AAATGTCCGCTCCGGCAAA
CCTTCACCGTCGTCTGTCA -> CTTCACCGTCGTCTGTCAA
CCCATCGTGTCCAGAATAC -> CCATCGTGTCCAGAATACC
GAAAGTGAGGATGACTTAG -> AAAGTGAGGATGACTTAGC
GCAGGATTTCGCGCTACTC -> CAGGATTTCGCGCTACTCT
CAATTTCATGTGGGCTGGA -> AATTTCATGTGGGCTGGAT
AGACGCTCCGCATGAGTAA -> GACGCTCCGCATGAGTAAT
AATTTGCGGTTCTTAAGTA -> ATTTGCGGTTCTTAAGTAG
TAGCCGGTGAGACTACGAG -> AGCCGGTGAGACTACGAGA
ATCCAATCGCTGTACACAG -> TCCAATCGCTGTACACAGT
AGTCTTAGGGCGAATCCAG -> GTCTTAGGGCGAATCCAGT
TTCTGCCCTGACCCAATTG -> TCTGCCCTGACCCAATTGA
TAACCAGCTACCTAAAGGC -> AACCAGCTACCTAAAGGCA
CCATCGTGTCCAGAATACC -> CATCGTGTCCAGAATACCA
CAGAATACCATAATGAGTC -> AGAATACCATAATGAGTCT
GGATTAAACACTAGGCACA -> GATTAAACACTAGGCACAA
ACTCTTGCTGCCGAAAATA -> CTCTTGCTGCCGAAAATAA
CTGGATTCCCCCGGGCAAG -> TGGATTCCCCCGGGCAAGA
GAAACGATTCTCTCGTGGT -> AAACGATTCTCTCGTGGTT,AAACGATTCTCTCGTGGTT
TGATAACACTATGTTCCCC -> GATAACACTATGTTCCCCG
AGTGTTAGGGGCTCCAAAG -> GTGTTAGGGGCTCCAAAGT
AACTGCTAGGCATACGCAC -> ACTGCTAGGCATACGCACA
CTGAGATTCTGCCCTGACC -> TGAGATTCTGCCCTGACCC
GGCATACGCACAGCCAGTG -> GCATACGCACAGCCAGTGA
TCCACTAGCTACAACCGTC -> CCACTAGCTACAACCGTCT
AGCATTCATCGTGTTTTGC -> GCATTCATCGTGTTTTGCT
AAAAGCACTAGTGACTGAG -> AAAGCACTAGTGACTGAGC
GTCTTAGGGCGAATCCAGT -> TCTTAGGGCGAATCCAGTA
CGCGGGAGGTGGAGCCGTT -> GCGGGAGGTGGAGCCGTTG
CAACCTAAGCGACCTATTC -> AACCTAAGCGACCTATTCT
GTTCCCCGCAAACGAGTAC -> TTCCCCGCAAACGAGTACT
TGAGATTCTGCCCTGACCC -> GAGATTCTGCCCTGACCCA
CAGCCAGTGAGCAGGTTCG -> AGCCAGTGAGCAGGTTCGC
AAAGGAAACGATTCTCTCG -> AAGGAAACGATTCTCTCGT
CTGACCCAATTGAAAAGCA -> TGACCCAATTGAAAAGCAC
TGAGCAGGTTCGCTGATTC -> GAGCAGGTTCGCTGATTCG
TCTCTTCTTCTCCTACAAT -> CTCTTCTTCTCCTACAATT
TAAGAATGAGCTTCATCCT -> AAGAATGAGCTTCATCCTA
GTGTTGGCAAGCTGACTCG -> TGTTGGCAAGCTGACTCGA
GGGCATCGCACCAACCTAA -> GGCATCGCACCAACCTAAG
CAGTGAGCAGGTTCGCTGA -> AGTGAGCAGGTTCGCTGAT
AACATCGAGCCGTCGATTG -> ACATCGAGCCGTCGATTGT
TACGGCTAAGAATCCGTAC -> ACGGCTAAGAATCCGTACA
ATCTGGAAATCTTCTGTGG -> TCTGGAAATCTTCTGTGGG
TGCCGTTATGTACGGCTAA -> GCCGTTATGTACGGCTAAG
AACACAATGCGTCAGAGAG -> ACACAATGCGTCAGAGAGA
GCCGAGGACACTTACCTCG -> CCGAGGACACTTACCTCGA
CATGTGGGCTGGATTCCCC -> ATGTGGGCTGGATTCCCCC
GCCGTGACTCAAGTATCAA -> CCGTGACTCAAGTATCAAG
GGCCTCCTCCCCTCTATTG -> GCCTCCTCCCCTCTATTGC
CTATGTTAGCCCAGTTGCA -> TATGTTAGCCCAGTTGCAT
GGTTCCAAGGTATAGTAAG -> GTTCCAAGGTATAGTAAGC
TCTGAAGCTCCTTTGGCTA -> CTGAAGCTCCTTTGGCTAT
AAACCGCCGTGAAACGATT -> AACCGCCGTGAAACGATTC
CCTATTCTAGTACTGCCAA -> CTATTCTAGTACTGCCAAC
GTAGTACCCCTATATTCGT -> TAGTACCCCTATATTCGTC
TGCACCTAATGGCGAGTCT -> GCACCTAATGGCGAGTCTG
CCTCACTGGTCCGCTTTCA -> CTCACTGGTCCGCTTTCAA
AATATAAGAGTTGAGTCGA -> ATATAAGAGTTGAGTCGAG
CGGCAAAGATTCACACCGC -> GGCAAAGATTCACACCGCG
CACTTACCTCGAGGCGGAG -> ACTTACCTCGAGGCGGAGA
AATTGGATTCTCGAAGCGA -> ATTGGATTCTCGAAGCGAT
GCTGTACACAGTTCGCAGA -> CTGTACACAGTTCGCAGAT
ATGAGAACACAATGCGTCA -> TGAGAACACAATGCGTCAG
CGCAGTCTGCGATTGTATG -> GCAGTCTGCGATTGTATGC
ATGGTAGGTTGAATCATAG -> TGGTAGGTTGAATCATAGC
GCTAGCCGGTGAGACTACG -> CTAGCCGGTGAGACTACGA
ATTTTACCTAGCTAGCCGG -> TTTTACCTAGCTAGCCGGT
TCTCATCGGCCCTACTGAT -> CTCATCGGCCCTACTGATA
TACCCCCATGATCCTTCAC -> ACCCCCATGATCCTTCACC
CGCCCGTGTTGGCAAGCTG -> GCCCGTGTTGGCAAGCTGA
TCAATGTCCGCTCCGGCAA -> CAATGTCCGCTCCGGCAAA
CGTGGTTCCACAATGGTAG -> GTGGTTCCACAATGGTAGG
CAGCGTGCCGTTATGTACG -> AGCGTGCCGTTATGTACGG
GCACGTTAGCCCGGCATAG -> CACGTTAGCCCGGCATAGC
CGTTATGTACGGCTAAGAA -> GTTATGTACGGCTAAGAAT
TGTTTTGCTCGCTAGCGCA -> GTTTTGCTCGCTAGCGCAT
TTGTCCTTCATCCACAGGA -> TGTCCTTCATCCACAGGAG
GTGAAATTACAAATGTCCG -> TGAAATTACAAATGTCCGC
TAGGAGACGCTCCGCATGA -> AGGAGACGCTCCGCATGAG
CAGAGAGAGCGCTAAGTCC -> AGAGAGAGCGCTAAGTCCT
AAATCTTCTGTGGGCGGCA -> AATCTTCTGTGGGCGGCAG
GAAAAGCAATTTGCGGTTC -> AAAAGCAATTTGCGGTTCT
AAACCCGGCGGACGATTCT -> AACCCGGCGGACGATTCTC
ATCGGCACGTTAGCCCGGC -> TCGGCACGTTAGCCCGGCA
CTATATTCGTCATCCCGCG -> TATATTCGTCATCCCGCGT
TTCCCCAAATACGTGCGAA -> TCCCCAAATACGTGCGAAA
CGTGGTTCCAATAATGAGA -> GTGGTTCCAATAATGAGAA
CCCGTACTTGATAACACTA -> CCGTACTTGATAACACTAT
CAGGAGACTGGTTTGCAAC -> AGGAGACTGGTTTGCAACT
GGCTCCAAAGTCGTGCACC -> GCTCCAAAGTCGTGCACCT
TGATCGAATAGTACACTTC -> GATCGAATAGTACACTTCC
TAAGTGTTAGGGGCTCCAA -> AAGTGTTAGGGGCTCCAAA
AAACTAAATTGAAATGGAT -> AACTAAATTGAAATGGATG
TGAGTCGAGGTAGTACCCC -> GAGTCGAGGTAGTACCCCT
ACTCTTCCCCAAATACGTG -> CTCTTCCCCAAATACGTGC
CCCAGTTGCATACTGGTAT -> CCAGTTGCATACTGGTATA
ATCCTTCCTGCAGCGCTGC -> TCCTTCCTGCAGCGCTGCC
TCTATTGTTAAATTGAGGT -> CTATTGTTAAATTGAGGTA
TCCCTCTGTTTATCCCCGT -> CCCTCTGTTTATCCCCGTA
GCGAATTGCCTAAATAGCC -> CGAATTGCCTAAATAGCCA
CGTGTAACCGTTGTAAGTG -> GTGTAACCGTTGTAAGTGT
GTGAGCAGGTTCGCTGATT -> TGAGCAGGTTCGCTGATTC
ATGTTTCGGGACCCGTACT -> TGTTTCGGGACCCGTACTT
CTAACCAGCTACCTAAAGG -> TAACCAGCTACCTAAAGGC
GACCAACGCTAACACCACC -> ACCAACGCTAACACCACCA
TCGGGCATCGCACCAACCT -> CGGGCATCGCACCAACCTA
GCGATTGTATGCCCTCCAG -> CGATTGTATGCCCTCCAGG
AGGCATACGCACAGCCAGT -> GGCATACGCACAGCCAGTG
ATTCCCGTCTATGTTAGCC -> TTCCCGTCTATGTTAGCCC
TAAATTGAAATGGATGTTA -> AAATTGAAATGGATGTTAT
GTTGTAAGTGTTAGGGGCT -> TTGTAAGTGTTAGGGGCTC
GGAGACGCTCCGCATGAGT -> GAGACGCTCCGCATGAGTA
ATTCTCTCGTGGTTCCACA -> TTCTCTCGTGGTTCCACAA
TGTACGGCTAAGAATCCGT -> GTACGGCTAAGAATCCGTA
AACGCTAACACCACCATAG -> ACGCTAACACCACCATAGC
GTTACGATAGGAGACGCTC -> TTACGATAGGAGACGCTCC
GAAAACTAAATTGAAATGG -> AAAACTAAATTGAAATGGA
CGAGTCTGGATCCGGACTT -> GAGTCTGGATCCGGACTTT
GGGCGTGAAATTACAAATG -> GGCGTGAAATTACAAATGT
GTCTGTACCCCCATGATCC -> TCTGTACCCCCATGATCCT
ACTAGCTACAACCGTCTTT -> CTAGCTACAACCGTCTTTG
TAAGGACCAATCCTCACTG -> AAGGACCAATCCTCACTGG
TGCAACTATGCATTGGGCC -> GCAACTATGCATTGGGCCT
GCTAACACCACCATAGCAA -> CTAACACCACCATAGCAAC
AATGAGTCTATGGGGTGTC -> ATGAGTCTATGGGGTGTCT
TCGCAGATGAACGCGATTT -> CGCAGATGAACGCGATTTG
CTCGAGGCGGAGATAGCGT -> TCGAGGCGGAGATAGCGTG
CGTCTTTGAGCTCATATTT -> GTCTTTGAGCTCATATTTT
CGCTTTCTGAAGCTCCTTT -> GCTTTCTGAAGCTCCTTTG
ACTACAACAGACCGCACCG -> CTACAACAGACCGCACCGT
TAGCTAGCCGGTGAGACTA -> AGCTAGCCGGTGAGACTAC
ACCAACGCTAACACCACCA -> CCAACGCTAACACCACCAT
CGAATTGCCTAAATAGCCA -> GAATTGCCTAAATAGCCAT
AGTGAGGATGACTTAGCGA -> GTGAGGATGACTTAGCGAA
CCTACTGATAAAGCGGGCT -> CTACTGATAAAGCGGGCTG
CATACTGGTATATGGAAAA -> ATACTGGTATATGGAAAAC
TCGTGGTTCCACAATGGTA -> CGTGGTTCCACAATGGTAG
GGGGATCGTAAAAGCGGTC -> GGGATCGTAAAAGCGGTCT
TGGTTCCATCCAAACAACG -> GGTTCCATCCAAACAACGG
CCGCATGAGTAATATAAGA -> CGCATGAGTAATATAAGAG
GCGGCTCTTGGAAGCGCCC -> CGGCTCTTGGAAGCGCCCA
CTTCTCCTACAATTCGAAT -> TTCTCCTACAATTCGAATG
CCCCCCATCGTGTCCAGAA -> CCCCCATCGTGTCCAGAAT
TCCGGCAAAGATTCACACC -> CCGGCAAAGATTCACACCG
GCGTGATGGTCCACTAGCT -> CGTGATGGTCCACTAGCTA
CAAATACAAAGGAAACGAT -> AAATACAAAGGAAACGATT
GGATGTTATCGCATCAGTT -> GATGTTATCGCATCAGTTA
GCATTCATCGTGTTTTGCT -> CATTCATCGTGTTTTGCTC
CGTGATGGTCCACTAGCTA -> GTGATGGTCCACTAGCTAC
ACACTTCCATGGCCTTACT -> CACTTCCATGGCCTTACTA
CGAATAGTACACTTCCATG -> GAATAGTACACTTCCATGG
CCAATCGCTGTACACAGTT -> CAATCGCTGTACACAGTTC
CTCGTGGTTCCAAGGTATA -> TCGTGGTTCCAAGGTATAG
AGCGTGCCGTTATGTACGG -> GCGTGCCGTTATGTACGGC
TTGGATTCTCGAAGCGATC -> TGGATTCTCGAAGCGATCC
TTCATTATCGACGTGTAAC -> TCATTATCGACGTGTAACC
AACCTAAGGACCAATCCTC -> ACCTAAGGACCAATCCTCA
CCGCAAACGAGTACTCTTC -> CGCAAACGAGTACTCTTCC
CTCACTGGTCCGCTTTCAA -> TCACTGGTCCGCTTTCAAC
ACCTAAGGACCAATCCTCA -> CCTAAGGACCAATCCTCAC
CCCCCATGATCCTTCACCG -> CCCCATGATCCTTCACCGT
TCGGGACCCGTACTTGATA -> CGGGACCCGTACTTGATAA
GGAGACTCTTGCTGCCGAA -> GAGACTCTTGCTGCCGAAA
TTCCACAATGGTAGGTTGA -> TCCACAATGGTAGGTTGAA
GCTGCCGAAAATAAACGTC -> CTGCCGAAAATAAACGTCG
CCAGCGCGTAATCCGAAAG -> CAGCGCGTAATCCGAAAGT
TGCCGAGGAGACTCTTGCT -> GCCGAGGAGACTCTTGCTG
AATAGTCGATACTGCCGAG -> ATAGTCGATACTGCCGAGT
ATAACACTATGTTCCCCGC -> TAACACTATGTTCCCCGCA
CTTCCCCAAATACGTGCGA -> TTCCCCAAATACGTGCGAA
ACAAATGTCCGCTCCGGCA -> CAAATGTCCGCTCCGGCAA
GCGAGCTGTGCGCGGCTCT -> CGAGCTGTGCGCGGCTCTT
GGCCTATAATACGTTATCG -> GCCTATAATACGTTATCGG
AAATGGATGTTATCGCATC -> AATGGATGTTATCGCATCA
TGTACACAGTTCGCAGATG -> GTACACAGTTCGCAGATGA
TACCCCTATATTCGTCATC -> ACCCCTATATTCGTCATCC
ATTGTATGCCCTCCAGGAG -> TTGTATGCCCTCCAGGAGA
GCCTGTCTGTACCCCCATG -> CCTGTCTGTACCCCCATGA
GGAGGTGGAGCCGTTGAGA -> GAGGTGGAGCCGTTGAGAC
CACTTTTGACATTGCTTAC -> ACTTTTGACATTGCTTACG
CTAAATTGAAATGGATGTT -> TAAATTGAAATGGATGTTA
CTTCTAAGAATGAGCTTCA -> TTCTAAGAATGAGCTTCAT
TGAGGTATCCGTCCCGCCC -> GAGGTATCCGTCCCGCCCG
TTGGGATTAAACACTAGGC -> TGGGATTAAACACTAGGCA
TGCCGCAAACAGACATCGC -> GCCGCAAACAGACATCGCC
TGTTGGCAAGCTGACTCGA -> GTTGGCAAGCTGACTCGAA
TGAGACTACGAGAAAAGCA -> GAGACTACGAGAAAAGCAA
GCTCCGGCAAATACAAAGG -> CTCCGGCAAATACAAAGGA
CTTTGAGCTCATATTTTTA -> TTTGAGCTCATATTTTTAC
CTAGGCATACGCACAGCCA -> TAGGCATACGCACAGCCAG
TCTTCTGTGGGCGGCAGCA -> CTTCTGTGGGCGGCAGCAG
TGAGACACCCAAATAGTCT -> GAGACACCCAAATAGTCTT
GGCGTTAAGCAGGATTTCG -> GCGTTAAGCAGGATTTCGC
CAGCGCGTAATCCGAAAGT -> AGCGCGTAATCCGAAAGTG
AATGAGCTTCATCCTAGCG -> ATGAGCTTCATCCTAGCGA
GGACACTTACCTCGAGGCG -> GACACTTACCTCGAGGCGG
CGGCTCTTGGAAGCGCCCA -> GGCTCTTGGAAGCGCCCAA
GCAAACCGCCGTGAAACGA -> CAAACCGCCGTGAAACGAT
CCGGGCAAGACCAACGCTA -> CGGGCAAGACCAACGCTAA
ACAAAGGAAACGATTCTCT -> CAAAGGAAACGATTCTCTC
AGCTTCATCCTAGCGAGCT -> GCTTCATCCTAGCGAGCTG
AATCATAGCCTGTCTGTAC -> ATCATAGCCTGTCTGTACC
AGACTCTTGCTGCCGAAAA -> GACTCTTGCTGCCGAAAAT
TCTCTCGTGGTTCCAATAA -> CTCTCGTGGTTCCAATAAT
TGTTCCCCGCAAACGAGTA -> GTTCCCCGCAAACGAGTAC
TGCTGATCGAATAGTACAC -> GCTGATCGAATAGTACACT
TGTACCCCCATGATCCTTC -> GTACCCCCATGATCCTTCA
CACTTCTGAATCCGCGCTT -> ACTTCTGAATCCGCGCTTT
AGTGAGCAGGTTCGCTGAT -> GTGAGCAGGTTCGCTGATT
GCGCGTAATCCGAAAGTGA -> CGCGTAATCCGAAAGTGAG
ACGCGATTTGCGCAATAGG -> CGCGATTTGCGCAATAGGA
GAACAACTGTCTGCTGATC -> AACAACTGTCTGCTGATCG
ATTCTCGAAGCGATCCGAT -> TTCTCGAAGCGATCCGATG
AAACGTCGGAACTTATCAT -> AACGTCGGAACTTATCATA
TAGCGCATCCACTTTTGAC -> AGCGCATCCACTTTTGACA
GCACTGCTATAATTCTAAC -> CACTGCTATAATTCTAACT
CACCGCGATTCTCTCGTGG -> ACCGCGATTCTCTCGTGGT
AGGAGACTCTTGCTGCCGA -> GGAGACTCTTGCTGCCGAA
TCGCACCAACCTAAGGACC -> CGCACCAACCTAAGGACCA
GATTCTCGAAGCGATCCGA -> ATTCTCGAAGCGATCCGAT
TCCCGTCTATGTTAGCCCA -> CCCGTCTATGTTAGCCCAG
TCATATCCTAAGACGCACT -> CATATCCTAAGACGCACTT
ATAGGAGCCGCCTTAGCGT -> TAGGAGCCGCCTTAGCGTT
AGAGAGCGCTAAGTCCTGC -> GAGAGCGCTAAGTCCTGCC
AATACGTGCGAAATGAACA -> ATACGTGCGAAATGAACAA
TGTAACCGTTGTAAGTGTT -> GTAACCGTTGTAAGTGTTA
CCATCTATTGTTAAATTGA -> CATCTATTGTTAAATTGAG
TTGAGACACCCAAATAGTC -> TGAGACACCCAAATAGTCT
AGTACACTTCCATGGCCTT -> GTACACTTCCATGGCCTTA
TCCACTTTTGACATTGCTT -> CCACTTTTGACATTGCTTA
ATGGATGTTATCGCATCAG -> TGGATGTTATCGCATCAGT
GCGCGGCTCTTGGAAGCGC -> CGCGGCTCTTGGAAGCGCC
CGGCCCCCCATCGTGTCCA -> GGCCCCCCATCGTGTCCAG
TAATACGTTATCGGCACGT -> AATACGTTATCGGCACGTT
AGGGGCTCCAAAGTCGTGC -> GGGGCTCCAAAGTCGTGCA
TCCAAAGTCGTGCACCTAA -> CCAAAGTCGTGCACCTAAT
GCGTGCCGTTATGTACGGC -> CGTGCCGTTATGTACGGCT
ACCGTCGTCTGTCAATCGG -> CCGTCGTCTGTCAATCGGC
GCGTGACTTGTTGGGATTA -> CGTGACTTGTTGGGATTAA
ACTTTACGTTTCATATCCT -> CTTTACGTTTCATATCCTA
CGAATAGTCGATACTGCCG -> GAATAGTCGATACTGCCGA
TAAAAGCGGTCTGGCACTT -> AAAAGCGGTCTGGCACTTC
CAACTAACCAGCTACCTAA -> AACTAACCAGCTACCTAAA
CCAACTTTACGTTTCATAT -> CAACTTTACGTTTCATATC
CATAATGAGTCTATGGGGT -> ATAATGAGTCTATGGGGTG
CGAAAATAAACGTCGGAAC -> GAAAATAAACGTCGGAACT
TGAAGATCCAATCGCTGTA -> GAAGATCCAATCGCTGTAC
TCGGCCCTACTGATAAAGC -> CGGCCCTACTGATAAAGCG
CAAGGTATAGTAAGCAGCG -> AAGGTATAGTAAGCAGCGC
TGCATACTGGTATATGGAA -> GCATACTGGTATATGGAAA
TATCCCCGTAATTGGATTC -> ATCCCCGTAATTGGATTCT
CATCAATGTCCGCTCCGGC -> ATCAATGTCCGCTCCGGCA
TCGCTGTACACAGTTCGCA -> CGCTGTACACAGTTCGCAG
AGATGAACGCGATTTGCGC -> GATGAACGCGATTTGCGCA
TTAAGCAGGATTTCGCGCT -> TAAGCAGGATTTCGCGCTA
TTATGGCCGTGACTCAAGT -> TATGGCCGTGACTCAAGTA
AAGCTCCTTTGGCTATGGT -> AGCTCCTTTGGCTATGGTA
CCTGTCTGTACCCCCATGA -> CTGTCTGTACCCCCATGAT
GAAGCTCCTTTGGCTATGG -> AAGCTCCTTTGGCTATGGT
AATACGTTATCGGCACGTT -> ATACGTTATCGGCACGTTA
CTCGAAGCGATCCGATGAA -> TCGAAGCGATCCGATGAAG
TCCTAAGACGCACTTCTGA -> CCTAAGACGCACTTCTGAA
ATAGTCGATACTGCCGAGT -> TAGTCGATACTGCCGAGTA
CCAGGAGACTGGTTTGCAA -> CAGGAGACTGGTTTGCAAC
CGAGCCGTCGATTGTCCTT -> GAGCCGTCGATTGTCCTTC
ACCAGCGCGTAATCCGAAA -> CCAGCGCGTAATCCGAAAG
GATCGAATAGTACACTTCC -> ATCGAATAGTACACTTCCA
CCCCGCAAACGAGTACTCT -> CCCGCAAACGAGTACTCTT
AGTACGCGGGAGGTGGAGC -> GTACGCGGGAGGTGGAGCC
ATAGCCTGTCTGTACCCCC -> TAGCCTGTCTGTACCCCCA
GGCACTGCTATAATTCTAA -> GCACTGCTATAATTCTAAC
TCCTGCCGAGGAGACTCTT -> CCTGCCGAGGAGACTCTTG
AGGAGACGCTCCGCATGAG -> GGAGACGCTCCGCATGAGT
GGTTTGCAACTATGCATTG -> GTTTGCAACTATGCATTGG
TTTTCCACATTATGGCCGT -> TTTCCACATTATGGCCGTG
TAAGAATCCGTACAATCCT -> AAGAATCCGTACAATCCTT
GTTATCGCATCAGTTAGGC -> TTATCGCATCAGTTAGGCA
TACCTAAAGGCAAAGACCA -> ACCTAAAGGCAAAGACCAG
AAAGCGGGCTGGCCTCCTC -> AAGCGGGCTGGCCTCCTCC
ATCGAATAGTACACTTCCA -> TCGAATAGTACACTTCCAT
CCTTAGCGTTACGATAGGA -> CTTAGCGTTACGATAGGAG
ACCTAATGGCGAGTCTGGA -> CCTAATGGCGAGTCTGGAT
GTTGAGACACCCAAATAGT -> TTGAGACACCCAAATAGTC
CCGATGAAGATCCAATCGC -> CGATGAAGATCCAATCGCT
GTACTCTTCCCCAAATACG -> TACTCTTCCCCAAATACGT
CTAACTGCTAGGCATACGC -> TAACTGCTAGGCATACGCA
GTACGCGGGAGGTGGAGCC -> TACGCGGGAGGTGGAGCCG
TAGCGAGCTGTGCGCGGCT -> AGCGAGCTGTGCGCGGCTC
GAGAGCGCTAAGTCCTGCC -> AGAGCGCTAAGTCCTGCCG
CACACCGCGATTCTCTCGT -> ACACCGCGATTCTCTCGTG
CGCTCCGGCAAATACAAAG -> GCTCCGGCAAATACAAAGG
GGCGAATCCAGTATATGAT -> GCGAATCCAGTATATGATT
AAGACGCACTTCTGAATCC -> AGACGCACTTCTGAATCCG
GGATTCTCGAAGCGATCCG -> GATTCTCGAAGCGATCCGA
GATAGGAGACGCTCCGCAT -> ATAGGAGACGCTCCGCATG
TTCCATCCAAACAACGGAT -> TCCATCCAAACAACGGATC
GTACTGCCAACTTTACGTT -> TACTGCCAACTTTACGTTT
GGACCAATCCTCACTGGTC -> GACCAATCCTCACTGGTCC
GATGACTTAGCGAATTGCC -> ATGACTTAGCGAATTGCCT
GAGGCGGAGATAGCGTGAC -> AGGCGGAGATAGCGTGACT
TAAGACGCACTTCTGAATC -> AAGACGCACTTCTGAATCC
TACGCGGGAGGTGGAGCCG -> ACGCGGGAGGTGGAGCCGT
TTCATATCCTAAGACGCAC -> TCATATCCTAAGACGCACT
TGTTAGCCCAGTTGCATAC -> GTTAGCCCAGTTGCATACT
AATCCGTACAATCCTTCCT -> ATCCGTACAATCCTTCCTG
ATTTGCGGTTCTTAAGTAG -> TTTGCGGTTCTTAAGTAGG
TATTGCCGCAAACAGACAT -> ATTGCCGCAAACAGACATC
TTTATTTTTCCACATTATG -> TTATTTTTCCACATTATGG
CTGCCGAAAATAAACGTCG -> TGCCGAAAATAAACGTCGG
ACTAGGCACAATTTCATGT -> CTAGGCACAATTTCATGTG
CGCACCGTTTGGGAAATTT -> GCACCGTTTGGGAAATTTT
TGCAGCGCTGCCCATGCTG -> GCAGCGCTGCCCATGCTGG
TTTGCGCAATAGGAGCCGC -> TTGCGCAATAGGAGCCGCC
TTATCATAATCTTACGCGG -> TATCATAATCTTACGCGGC
CGTGTTGGCAAGCTGACTC -> GTGTTGGCAAGCTGACTCG
ACTGTCTGCTGATCGAATA -> CTGTCTGCTGATCGAATAG
GACCCAATTGAAAAGCACT -> ACCCAATTGAAAAGCACTA
CCCTGAGATTCTGCCCTGA -> CCTGAGATTCTGCCCTGAC
GTGTTAGGGGCTCCAAAGT -> TGTTAGGGGCTCCAAAGTC
GAGACTACGAGAAAAGCAA -> AGACTACGAGAAAAGCAAT
CCAATCCTCACTGGTCCGC -> CAATCCTCACTGGTCCGCT
CTATAATTCTAACTGCTAG -> TATAATTCTAACTGCTAGG
AGACACCCAAATAGTCTTA -> GACACCCAAATAGTCTTAG
AATGAACAACTGTCTGCTG -> ATGAACAACTGTCTGCTGA
ACACCCAAATAGTCTTAGG -> CACCCAAATAGTCTTAGGG
CAGTATATGATTTCATTCC -> AGTATATGATTTCATTCCC
CTGCTGATCGAATAGTACA -> TGCTGATCGAATAGTACAC
CAAATACGTGCGAAATGAA -> AAATACGTGCGAAATGAAC
TAGTAAGCAGCGCATTCAT -> AGTAAGCAGCGCATTCATT
GAACCTGGGGATCGTAAAA -> AACCTGGGGATCGTAAAAG
CCTATAATACGTTATCGGC -> CTATAATACGTTATCGGCA
GAGCCGCCTTAGCGTTACG -> AGCCGCCTTAGCGTTACGA
AAGCGGTCTGGCACTTCTA -> AGCGGTCTGGCACTTCTAA
GGAGCCGTTGAGACACCCA -> GAGCCGTTGAGACACCCAA
TGGATTCCCCCGGGCAAGA -> GGATTCCCCCGGGCAAGAC
GGTGTCTCACGCAGTCTGC -> GTGTCTCACGCAGTCTGCG
CGGCAGCAGCATTCATCGT -> GGCAGCAGCATTCATCGTG
AAAGTCGTGCACCTAATGG -> AAGTCGTGCACCTAATGGC
GACCGCACCGTTTGGGAAA -> ACCGCACCGTTTGGGAAAT
GTCGGAACTTATCATAATC -> TCGGAACTTATCATAATCT
TGGATCCGGACTTTGATGG -> GGATCCGGACTTTGATGGC
TGGGGATCGTAAAAGCGGT -> GGGGATCGTAAAAGCGGTC
CGCACCAACCTAAGGACCA -> GCACCAACCTAAGGACCAA
CATGCTGGGCGTGAAATTA -> ATGCTGGGCGTGAAATTAC
CTCGCTAGCGCATCCACTT -> TCGCTAGCGCATCCACTTT
TCATAGCCTGTCTGTACCC -> CATAGCCTGTCTGTACCCC
TCTTCTTCTCCTACAATTC -> CTTCTTCTCCTACAATTCG
GCAATAGGAGCCGCCTTAG -> CAATAGGAGCCGCCTTAGC
GCGGGCTGGCCTCCTCCCC -> CGGGCTGGCCTCCTCCCCT
TAATTCTAACTGCTAGGCA -> AATTCTAACTGCTAGGCAT
AACACCACCATAGCAACAT -> ACACCACCATAGCAACATC
TCGTCTGTCAATCGGCCCC -> CGTCTGTCAATCGGCCCCC
TCCCGCGTGATGGTCCACT -> CCCGCGTGATGGTCCACTA
TCGGCACGTTAGCCCGGCA -> CGGCACGTTAGCCCGGCAT
TCGTGGTTCCAAGGTATAG -> CGTGGTTCCAAGGTATAGT
AGGGCGAATCCAGTATATG -> GGGCGAATCCAGTATATGA
TCACCGTCGTCTGTCAATC -> CACCGTCGTCTGTCAATCG
CCGCACCGTTTGGGAAATT -> CGCACCGTTTGGGAAATTT
GCACCAACCTAAGGACCAA -> CACCAACCTAAGGACCAAT
GTCCGCTCCGGCAAAGATT -> TCCGCTCCGGCAAAGATTC
TAGCGAATTGCCTAAATAG -> AGCGAATTGCCTAAATAGC
CTCGGTTTGGGCCTATAAT -> TCGGTTTGGGCCTATAATA
CCCTCTGTTTATCCCCGTA -> CCTCTGTTTATCCCCGTAA
CCCCGTAATTGGATTCTCG -> CCCGTAATTGGATTCTCGA
ATAGTACACTTCCATGGCC -> TAGTACACTTCCATGGCCT
GTTAGGGGCTCCAAAGTCG -> TTAGGGGCTCCAAAGTCGT
AAAGTGAGGATGACTTAGC -> AAGTGAGGATGACTTAGCG
AAGTGTTAGGGGCTCCAAA -> AGTGTTAGGGGCTCCAAAG
AGCCATTTATTTTTCCACA -> GCCATTTATTTTTCCACAT
CATCAGTTAGGCACTGCTA -> ATCAGTTAGGCACTGCTAT
TATGCATTGGGCCTACTAT -> ATGCATTGGGCCTACTATC
CTCCAAAGTCGTGCACCTA -> TCCAAAGTCGTGCACCTAA
ACTGAGCAGCGTGCCGTTA -> CTGAGCAGCGTGCCGTTAT
TACACTTCCATCAATGTCC -> ACACTTCCATCAATGTCCG
AAAGCGGTCTGGCACTTCT -> AAGCGGTCTGGCACTTCTA
TGAATCATAGCCTGTCTGT -> GAATCATAGCCTGTCTGTA
GCCCATGCTGGGCGTGAAA -> CCCATGCTGGGCGTGAAAT
TAATGAGAACACAATGCGT -> AATGAGAACACAATGCGTC
ATGACTTAGCGAATTGCCT -> TGACTTAGCGAATTGCCTA
CGTGAAATTACAAATGTCC -> GTGAAATTACAAATGTCCG
GATACTGCCGAGTACGCGG -> ATACTGCCGAGTACGCGGG
AGAGTTGAGTCGAGGTAGT -> GAGTTGAGTCGAGGTAGTA
CATTGTCCCTGAGATTCTG -> ATTGTCCCTGAGATTCTGC
ACCCCTATATTCGTCATCC -> CCCCTATATTCGTCATCCC
GCATACTGGTATATGGAAA -> CATACTGGTATATGGAAAA
CTAAATAGCCATTTATTTT -> TAAATAGCCATTTATTTTT
ACCCGGCGGACGATTCTCT -> CCCGGCGGACGATTCTCTC
GCGATTCTCTCGTGGTTCC -> CGATTCTCTCGTGGTTCCA
TTACGTTTCATATCCTAAG -> TACGTTTCATATCCTAAGA
CCCGGCATAGCTATGTTTC -> CCGGCATAGCTATGTTTCG
TAGGCACTGCTATAATTCT -> AGGCACTGCTATAATTCTA
AGCGATCCGATGAAGATCC -> GCGATCCGATGAAGATCCA
GATCCTTCACCGTCGTCTG -> ATCCTTCACCGTCGTCTGT
TCCGCGCTTTCTGAAGCTC -> CCGCGCTTTCTGAAGCTCC
CTCCGGCAAACCGCCGTGA -> TCCGGCAAACCGCCGTGAA
GTCTGGCACTTCTAAGAAT -> TCTGGCACTTCTAAGAATG
ATGCGTCAGAGAGAGCGCT -> TGCGTCAGAGAGAGCGCTA
GAGGAACCTGGGGATCGTA -> AGGAACCTGGGGATCGTAA
CGGTGAGACTACGAGAAAA -> GGTGAGACTACGAGAAAAG
CTGTGCGCGGCTCTTGGAA -> TGTGCGCGGCTCTTGGAAG
GGAAATTTTACCTAGCTAG -> GAAATTTTACCTAGCTAGC
TCCGCTTTCAACCTAAGCG -> CCGCTTTCAACCTAAGCGA
TATCATAATCTTACGCGGC -> ATCATAATCTTACGCGGCA
ACACTATGTTCCCCGCAAA -> CACTATGTTCCCCGCAAAC
TACAACCGTCTTTGAGCTC -> ACAACCGTCTTTGAGCTCA
CGGCAAACCGCCGTGAAAC -> GGCAAACCGCCGTGAAACG
CAGGATTTCGCGCTACTCT -> AGGATTTCGCGCTACTCTC
TGTCCAGAATACCATAATG -> GTCCAGAATACCATAATGA
GAAGCGCCCAACTAACCAG -> AAGCGCCCAACTAACCAGC
ATCGCCGAGGACACTTACC -> TCGCCGAGGACACTTACCT
ATTCTCTCGTGGTTCCAAG -> TTCTCTCGTGGTTCCAAGG
AGTCGATACTGCCGAGTAC -> GTCGATACTGCCGAGTACG
CCGAATAAATTGACCATCT -> CGAATAAATTGACCATCTA
CAATAATGAGAACACAATG -> AATAATGAGAACACAATGC
TCGGTTTGGGCCTATAATA -> CGGTTTGGGCCTATAATAC
AACCAGCTACCTAAAGGCA -> ACCAGCTACCTAAAGGCAA
ATTCTCTCGTGGTTCCAAT -> TTCTCTCGTGGTTCCAATA
ACTCTCATCGGCCCTACTG -> CTCTCATCGGCCCTACTGA
ATCTTACGCGGCATTGTCC -> TCTTACGCGGCATTGTCCC
TCGACGTGTAACCGTTGTA -> CGACGTGTAACCGTTGTAA
TAACACCACCATAGCAACA -> AACACCACCATAGCAACAT
GGTCCACTAGCTACAACCG -> GTCCACTAGCTACAACCGT
CTTCCATGGCCTTACTACA -> TTCCATGGCCTTACTACAA
CTGGTTTGCAACTATGCAT -> TGGTTTGCAACTATGCATT
TAGGAGCCGCCTTAGCGTT -> AGGAGCCGCCTTAGCGTTA
AATTCTAACTGCTAGGCAT -> ATTCTAACTGCTAGGCATA
CTCATATTTTTACACGATA -> TCATATTTTTACACGATAG
GGAAGCGCCCAACTAACCA -> GAAGCGCCCAACTAACCAG
CCTGCCGAGGAGACTCTTG -> CTGCCGAGGAGACTCTTGC
CATACGCACAGCCAGTGAG -> ATACGCACAGCCAGTGAGC
CTTTCAACCTAAGCGACCT -> TTTCAACCTAAGCGACCTA
CAGTTCGCAGATGAACGCG -> AGTTCGCAGATGAACGCGA
CTCTATTGCCGCAAACAGA -> TCTATTGCCGCAAACAGAC
TGGAAGCGCCCAACTAACC -> GGAAGCGCCCAACTAACCA
GCTTACGAGATCGAGCGAA -> CTTACGAGATCGAGCGAAT
CAAGCTGACTCGAATAGTC -> AAGCTGACTCGAATAGTCG
GTGGAGCCGTTGAGACACC -> TGGAGCCGTTGAGACACCC
CGTCGATTGTCCTTCATCC -> GTCGATTGTCCTTCATCCA
CTAGCTACAACCGTCTTTG -> TAGCTACAACCGTCTTTGA
TCGAGCCGTCGATTGTCCT -> CGAGCCGTCGATTGTCCTT
TAAACACTAGGCACAATTT -> AAACACTAGGCACAATTTC
GCCGAGTACGCGGGAGGTG -> CCGAGTACGCGGGAGGTGG
TTAGCGTTACGATAGGAGA -> TAGCGTTACGATAGGAGAC
CTATGTTCCCCGCAAACGA -> TATGTTCCCCGCAAACGAG
CATTGCTTACGAGATCGAG -> ATTGCTTACGAGATCGAGC
ATTGAAAAGCACTAGTGAC -> TTGAAAAGCACTAGTGACT
TCCCCAAATACGTGCGAAA -> CCCCAAATACGTGCGAAAT
TCAATCGGCCCCCCATCGT -> CAATCGGCCCCCCATCGTG
AGACCGCACCGTTTGGGAA -> GACCGCACCGTTTGGGAAA
CCGGCAAACCGCCGTGAAA -> CGGCAAACCGCCGTGAAAC
CTAATGGCGAGTCTGGATC -> TAATGGCGAGTCTGGATCC
CCGCCTTAGCGTTACGATA -> CGCCTTAGCGTTACGATAG
TAGCGTGACTTGTTGGGAT -> AGCGTGACTTGTTGGGATT
ATTGCCGCAAACAGACATC -> TTGCCGCAAACAGACATCG
CTTCACCGTCGTCTGTCAA -> TTCACCGTCGTCTGTCAAT
TACGCACAGCCAGTGAGCA -> ACGCACAGCCAGTGAGCAG
GCTCCGGCAAAGATTCACA -> CTCCGGCAAAGATTCACAC
GTTGAATCATAGCCTGTCT -> TTGAATCATAGCCTGTCTG
TCTGAATCCGCGCTTTCTG -> CTGAATCCGCGCTTTCTGA
ATACCATAATGAGTCTATG -> TACCATAATGAGTCTATGG
CGCTAGCGCATCCACTTTT -> GCTAGCGCATCCACTTTTG
CAACTTTACGTTTCATATC -> AACTTTACGTTTCATATCC
CCGTCGATTGTCCTTCATC -> CGTCGATTGTCCTTCATCC
TGACCCAATTGAAAAGCAC -> GACCCAATTGAAAAGCACT
ATCATAATCTTACGCGGCA -> TCATAATCTTACGCGGCAT
CTGGCCTCCTCCCCTCTAT -> TGGCCTCCTCCCCTCTATT
CTGGGCGTGAAATTACAAA -> TGGGCGTGAAATTACAAAT
GCTCCGGCAAACCGCCGTG -> CTCCGGCAAACCGCCGTGA
ACACTAGGCACAATTTCAT -> CACTAGGCACAATTTCATG
GGTTCCATCCAAACAACGG -> GTTCCATCCAAACAACGGA
ACGGCTAAGAATCCGTACA -> CGGCTAAGAATCCGTACAA
CCATTTATTTTTCCACATT -> CATTTATTTTTCCACATTA
TGCCCTCCAGGAGACTGGT -> GCCCTCCAGGAGACTGGTT
ATCGGCCCCCCATCGTGTC -> TCGGCCCCCCATCGTGTCC
AAAGGCAAAGACCAGCGCG -> AAGGCAAAGACCAGCGCGT
CGAGGACACTTACCTCGAG -> GAGGACACTTACCTCGAGG
ACATCGAGCCGTCGATTGT -> CATCGAGCCGTCGATTGTC
CACCTAATGGCGAGTCTGG -> ACCTAATGGCGAGTCTGGA
TGAAATTACAAATGTCCGC -> GAAATTACAAATGTCCGCT
TTGTAAGTGTTAGGGGCTC -> TGTAAGTGTTAGGGGCTCC
GTCCCTGAGATTCTGCCCT -> TCCCTGAGATTCTGCCCTG
TTCTGAAGCTCCTTTGGCT -> TCTGAAGCTCCTTTGGCTA
TAAGCAGGATTTCGCGCTA -> AAGCAGGATTTCGCGCTAC
ATGGCGTTAAGCAGGATTT -> TGGCGTTAAGCAGGATTTC
CGGCACGTTAGCCCGGCAT -> GGCACGTTAGCCCGGCATA
TCGAGGCGGAGATAGCGTG -> CGAGGCGGAGATAGCGTGA
TTCAACCTAAGCGACCTAT -> TCAACCTAAGCGACCTATT
GCGAGTCTGGATCCGGACT -> CGAGTCTGGATCCGGACTT
CGATTGTCCTTCATCCACA -> GATTGTCCTTCATCCACAG
CCGCCCGTGTTGGCAAGCT -> CGCCCGTGTTGGCAAGCTG
AATCCGCGCTTTCTGAAGC -> ATCCGCGCTTTCTGAAGCT
GAATAGTCGATACTGCCGA -> AATAGTCGATACTGCCGAG
TGGAAAACTAAATTGAAAT -> GGAAAACTAAATTGAAATG
ATATCCTAAGACGCACTTC -> TATCCTAAGACGCACTTCT
TATGGAAAACTAAATTGAA -> ATGGAAAACTAAATTGAAA
GGCAAAGACCAGCGCGTAA -> GCAAAGACCAGCGCGTAAT
TAAAGGCAAAGACCAGCGC -> AAAGGCAAAGACCAGCGCG
CACAGGAGGAACCTGGGGA -> ACAGGAGGAACCTGGGGAT
ATATGGAAAACTAAATTGA -> TATGGAAAACTAAATTGAA
CTTCCTGCAGCGCTGCCCA -> TTCCTGCAGCGCTGCCCAT
CTCCCCTCTATTGCCGCAA -> TCCCCTCTATTGCCGCAAA
TGAATCCGCGCTTTCTGAA -> GAATCCGCGCTTTCTGAAG
GCGGCAGCAGCATTCATCG -> CGGCAGCAGCATTCATCGT
CTGAATCCGCGCTTTCTGA -> TGAATCCGCGCTTTCTGAA
CTTATCATAATCTTACGCG -> TTATCATAATCTTACGCGG
GGGCGAATCCAGTATATGA -> GGCGAATCCAGTATATGAT
CTGTGGGCGGCAGCAGCAT -> TGTGGGCGGCAGCAGCATT
CACAGTTCGCAGATGAACG -> ACAGTTCGCAGATGAACGC
GTGTAACCGTTGTAAGTGT -> TGTAACCGTTGTAAGTGTT
ATGTTCCCCGCAAACGAGT -> TGTTCCCCGCAAACGAGTA
CACGTTAGCCCGGCATAGC -> ACGTTAGCCCGGCATAGCT
AGTCGAGGTAGTACCCCTA -> GTCGAGGTAGTACCCCTAT
AAGTCCTGCCGAGGAGACT -> AGTCCTGCCGAGGAGACTC
ATTCGTCATCCCGCGTGAT -> TTCGTCATCCCGCGTGATG
GTGCCGTTATGTACGGCTA -> TGCCGTTATGTACGGCTAA
CTCTCGTGGTTCCAATAAT -> TCTCGTGGTTCCAATAATG
TCGTGTCCAGAATACCATA -> CGTGTCCAGAATACCATAA
TACACTTCCATGGCCTTAC -> ACACTTCCATGGCCTTACT
TTGCTTACGAGATCGAGCG -> TGCTTACGAGATCGAGCGA
AAATTACAAATGTCCGCTC -> AATTACAAATGTCCGCTCC
GCTGTGCGCGGCTCTTGGA -> CTGTGCGCGGCTCTTGGAA
GAGTCTATGGGGTGTCTCA -> AGTCTATGGGGTGTCTCAC
GTGCGAAATGAACAACTGT -> TGCGAAATGAACAACTGTC
TGTTTATCCCCGTAATTGG -> GTTTATCCCCGTAATTGGA
TACTGCCGAGTACGCGGGA -> ACTGCCGAGTACGCGGGAG
TTCCAAGGTATAGTAAGCA -> TCCAAGGTATAGTAAGCAG
ACTGCTAGGCATACGCACA -> CTGCTAGGCATACGCACAG
TGACCATCTATTGTTAAAT -> GACCATCTATTGTTAAATT
ACTAACCAGCTACCTAAAG -> CTAACCAGCTACCTAAAGG
TTGCATACTGGTATATGGA -> TGCATACTGGTATATGGAA
CGAAAGTGAGGATGACTTA -> GAAAGTGAGGATGACTTAG
ACCTAAGCGACCTATTCTA -> CCTAAGCGACCTATTCTAG
CTGGAAATCTTCTGTGGGC -> TGGAAATCTTCTGTGGGCG
CTATTGTTAAATTGAGGTA -> TATTGTTAAATTGAGGTAT
TTGAGGTATCCGTCCCGCC -> TGAGGTATCCGTCCCGCCC
AACGATTCTCTCGTGGTTC -> ACGATTCTCTCGTGGTTCC,ACGATTCTCTCGTGGTTCC
TGAGTAATATAAGAGTTGA -> GAGTAATATAAGAGTTGAG
CTATGGGGTGTCTCACGCA -> TATGGGGTGTCTCACGCAG
CCGTGAAACGATTCTCTCG -> CGTGAAACGATTCTCTCGT
TAGTACTGCCAACTTTACG -> AGTACTGCCAACTTTACGT
TTCGTCATCCCGCGTGATG -> TCGTCATCCCGCGTGATGG
TCGAAGCGATCCGATGAAG -> CGAAGCGATCCGATGAAGA
TCTTTGAGCTCATATTTTT -> CTTTGAGCTCATATTTTTA
CCGCTTTCAACCTAAGCGA -> CGCTTTCAACCTAAGCGAC
GGCAAAAACCCGGCGGACG -> GCAAAAACCCGGCGGACGA
GCAAGACCAACGCTAACAC -> CAAGACCAACGCTAACACC
ACCCGTACTTGATAACACT -> CCCGTACTTGATAACACTA
ATGGGGTGTCTCACGCAGT -> TGGGGTGTCTCACGCAGTC
GGGAGGTGGAGCCGTTGAG -> GGAGGTGGAGCCGTTGAGA
ACCTATTCTAGTACTGCCA -> CCTATTCTAGTACTGCCAA
AGCTACCTAAAGGCAAAGA -> GCTACCTAAAGGCAAAGAC
AACGTCGGAACTTATCATA -> ACGTCGGAACTTATCATAA
GGCAAGCTGACTCGAATAG -> GCAAGCTGACTCGAATAGT
CTGCCAACTTTACGTTTCA -> TGCCAACTTTACGTTTCAT
AGCCGGTGAGACTACGAGA -> GCCGGTGAGACTACGAGAA
AAATGAACAACTGTCTGCT -> AATGAACAACTGTCTGCTG
CGTGTTTTGCTCGCTAGCG -> GTGTTTTGCTCGCTAGCGC
TCCGTACAATCCTTCCTGC -> CCGTACAATCCTTCCTGCA
TGTCTGTACCCCCATGATC -> GTCTGTACCCCCATGATCC
TATGTTAGCCCAGTTGCAT -> ATGTTAGCCCAGTTGCATA
CTCTTGGAAGCGCCCAACT -> TCTTGGAAGCGCCCAACTA
CCTGCAGCGCTGCCCATGC -> CTGCAGCGCTGCCCATGCT
AGGAGGAACCTGGGGATCG -> GGAGGAACCTGGGGATCGT
CAGGAGGAACCTGGGGATC -> AGGAGGAACCTGGGGATCG
CTGGATCCGGACTTTGATG -> TGGATCCGGACTTTGATGG
CCTAGCGAGCTGTGCGCGG -> CTAGCGAGCTGTGCGCGGC
TTTCGGGACCCGTACTTGA -> TTCGGGACCCGTACTTGAT
CTTAGCGAATTGCCTAAAT -> TTAGCGAATTGCCTAAATA
GTAGGTTGAATCATAGCCT -> TAGGTTGAATCATAGCCTG
GCATCGCACCAACCTAAGG -> CATCGCACCAACCTAAGGA
GGTGAGACTACGAGAAAAG -> GTGAGACTACGAGAAAAGC
CGTGCACCTAATGGCGAGT -> GTGCACCTAATGGCGAGTC
TCCATCCAAACAACGGATC -> CCATCCAAACAACGGATCT
AGACCAACGCTAACACCAC -> GACCAACGCTAACACCACC
GGTAATGTCCGCTCCGGCA -> GTAATGTCCGCTCCGGCAA
TAGTACACTTCCATGGCCT -> AGTACACTTCCATGGCCTT
TAAGCAGCGCATTCATTAT -> AAGCAGCGCATTCATTATC
CGATCCGATGAAGATCCAA -> GATCCGATGAAGATCCAAT
AGGATGACTTAGCGAATTG -> GGATGACTTAGCGAATTGC
ATAAATTGACCATCTATTG -> TAAATTGACCATCTATTGT
GTCCGCTCCGGCAAAAACC -> TCCGCTCCGGCAAAAACCC
CGTTAGCCCGGCATAGCTA -> GTTAGCCCGGCATAGCTAT
AACGCGATTTGCGCAATAG -> ACGCGATTTGCGCAATAGG
CTTCTGAATCCGCGCTTTC -> TTCTGAATCCGCGCTTTCT
ATTCTCTCGTGGTTCCATC -> TTCTCTCGTGGTTCCATCC
TCTCGTGGTTCCAATAATG -> CTCGTGGTTCCAATAATGA
ACCGTTGTAAGTGTTAGGG -> CCGTTGTAAGTGTTAGGGG
ACTCAAGTATCAAGTTACC -> CTCAAGTATCAAGTTACCG
GCGTAATCCGAAAGTGAGG -> CGTAATCCGAAAGTGAGGA
TCACACCGCGATTCTCTCG -> CACACCGCGATTCTCTCGT
CGTCGGAACTTATCATAAT -> GTCGGAACTTATCATAATC
CTGTTTATCCCCGTAATTG -> TGTTTATCCCCGTAATTGG
AGTTACCGAATAAATTGAC -> GTTACCGAATAAATTGACC
TCTGTGGGCGGCAGCAGCA -> CTGTGGGCGGCAGCAGCAT
GAGTAATATAAGAGTTGAG -> AGTAATATAAGAGTTGAGT
TGGTAATGTCCGCTCCGGC -> GGTAATGTCCGCTCCGGCA
GTCGTCTGTCAATCGGCCC -> TCGTCTGTCAATCGGCCCC
GTAGGAACTACACTTCCAT -> TAGGAACTACACTTCCATC
CCGCAAACAGACATCGCCG -> CGCAAACAGACATCGCCGA
GTTTGCAACTATGCATTGG -> TTTGCAACTATGCATTGGG
ATACGCACAGCCAGTGAGC -> TACGCACAGCCAGTGAGCA
AGGATTTCGCGCTACTCTC -> GGATTTCGCGCTACTCTCA
TTGAAAAGCACTAGTGACT -> TGAAAAGCACTAGTGACTG
TTGAAATGGATGTTATCGC -> TGAAATGGATGTTATCGCA
GCCCAACTAACCAGCTACC -> CCCAACTAACCAGCTACCT
TCGTGTTTTGCTCGCTAGC -> CGTGTTTTGCTCGCTAGCG
GATTGTCCTTCATCCACAG -> ATTGTCCTTCATCCACAGG
TTGAGTCGAGGTAGTACCC -> TGAGTCGAGGTAGTACCCC
AAGTTACCGAATAAATTGA -> AGTTACCGAATAAATTGAC
ATGTACGGCTAAGAATCCG -> TGTACGGCTAAGAATCCGT
CTGTACCCCCATGATCCTT -> TGTACCCCCATGATCCTTC
GAGGATGACTTAGCGAATT -> AGGATGACTTAGCGAATTG
GTGGTTCCAATAATGAGAA -> TGGTTCCAATAATGAGAAC
GTATGCCCTCCAGGAGACT -> TATGCCCTCCAGGAGACTG
TCCACATTATGGCCGTGAC -> CCACATTATGGCCGTGACT
GGAAACGATTCTCTCGTGG -> GAAACGATTCTCTCGTGGT
GCCGTGAAACGATTCTCTC -> CCGTGAAACGATTCTCTCG
AAGTCGTGCACCTAATGGC -> AGTCGTGCACCTAATGGCG
CACTAGGCACAATTTCATG -> ACTAGGCACAATTTCATGT
CATGATCCTTCACCGTCGT -> ATGATCCTTCACCGTCGTC
ACTGCCGAGTACGCGGGAG -> CTGCCGAGTACGCGGGAGG
TGTGCGCGGCTCTTGGAAG -> GTGCGCGGCTCTTGGAAGC
TGGCAAGCTGACTCGAATA -> GGCAAGCTGACTCGAATAG
TTGGAAGCGCCCAACTAAC -> TGGAAGCGCCCAACTAACC
TAGCTATGTTTCGGGACCC -> AGCTATGTTTCGGGACCCG
AACTAAATTGAAATGGATG -> ACTAAATTGAAATGGATGT
TAGTACCCCTATATTCGTC -> AGTACCCCTATATTCGTCA
TCCATCAATGTCCGCTCCG -> CCATCAATGTCCGCTCCGG
TCCAGAATACCATAATGAG -> CCAGAATACCATAATGAGT
GTCGAGGTAGTACCCCTAT -> TCGAGGTAGTACCCCTATA
GCGGTTCTTAAGTAGGAAC -> CGGTTCTTAAGTAGGAACT
CTCGAATAGTCGATACTGC -> TCGAATAGTCGATACTGCC
CCGTCGTCTGTCAATCGGC -> CGTCGTCTGTCAATCGGCC
CGGTTTGGGCCTATAATAC -> GGTTTGGGCCTATAATACG
CATTCATTATCGACGTGTA -> ATTCATTATCGACGTGTAA
AGTACCCCTATATTCGTCA -> GTACCCCTATATTCGTCAT
TCTCTCGTGGTTCCAAGGT -> CTCTCGTGGTTCCAAGGTA
TTATCGCATCAGTTAGGCA -> TATCGCATCAGTTAGGCAC
ATGAACGCGATTTGCGCAA -> TGAACGCGATTTGCGCAAT
CGTAAAAGCGGTCTGGCAC -> GTAAAAGCGGTCTGGCACT
TATATGATTTCATTCCCGT -> ATATGATTTCATTCCCGTC
ATGTCCGCTCCGGCAAATA -> TGTCCGCTCCGGCAAATAC
CAGTTGCATACTGGTATAT -> AGTTGCATACTGGTATATG
AATCGGCCCCCCATCGTGT -> ATCGGCCCCCCATCGTGTC
TGTTATCGCATCAGTTAGG -> GTTATCGCATCAGTTAGGC
GCTACTCTCATCGGCCCTA -> CTACTCTCATCGGCCCTAC
ATAATTCTAACTGCTAGGC -> TAATTCTAACTGCTAGGCA
GAAAAGCACTAGTGACTGA -> AAAAGCACTAGTGACTGAG
ATAGTAAGCAGCGCATTCA -> TAGTAAGCAGCGCATTCAT
ATAGGAGACGCTCCGCATG -> TAGGAGACGCTCCGCATGA
TCAGAGAGAGCGCTAAGTC -> CAGAGAGAGCGCTAAGTCC
TTCATCCACAGGAGGAACC -> TCATCCACAGGAGGAACCT
CTGTCTGTACCCCCATGAT -> TGTCTGTACCCCCATGATC
GCCGAGGAGACTCTTGCTG -> CCGAGGAGACTCTTGCTGC
GACTACGAGAAAAGCAATT -> ACTACGAGAAAAGCAATTT
GAATAGTACACTTCCATGG -> AATAGTACACTTCCATGGC
GTCCTGCCGAGGAGACTCT -> TCCTGCCGAGGAGACTCTT
CGATTGTATGCCCTCCAGG -> GATTGTATGCCCTCCAGGA
AATTGAAATGGATGTTATC -> ATTGAAATGGATGTTATCG
CAATGCGTCAGAGAGAGCG -> AATGCGTCAGAGAGAGCGC
GGCAGCAGCATTCATCGTG -> GCAGCAGCATTCATCGTGT
GAGCTCATATTTTTACACG -> AGCTCATATTTTTACACGA
CCCATGATCCTTCACCGTC -> CCATGATCCTTCACCGTCG
TGGTATATGGAAAACTAAA -> GGTATATGGAAAACTAAAT
TCTGGAAATCTTCTGTGGG -> CTGGAAATCTTCTGTGGGC
TGGCCTTACTACAACAGAC -> GGCCTTACTACAACAGACC
GAGAGAGCGCTAAGTCCTG -> AGAGAGCGCTAAGTCCTGC
GCAACTATGCATTGGGCCT -> CAACTATGCATTGGGCCTA
TCCGAAAGTGAGGATGACT -> CCGAAAGTGAGGATGACTT
CTGGGGATCGTAAAAGCGG -> TGGGGATCGTAAAAGCGGT
AGACCAGCGCGTAATCCGA -> GACCAGCGCGTAATCCGAA
CTTACTACAACAGACCGCA -> TTACTACAACAGACCGCAC
GGATCGTAAAAGCGGTCTG -> GATCGTAAAAGCGGTCTGG
TGCGCAATAGGAGCCGCCT -> GCGCAATAGGAGCCGCCTT
ATAATGAGAACACAATGCG -> TAATGAGAACACAATGCGT
GACTGAGCAGCGTGCCGTT -> ACTGAGCAGCGTGCCGTTA
AAGGAAACGATTCTCTCGT -> AGGAAACGATTCTCTCGTG
ACGTGCGAAATGAACAACT -> CGTGCGAAATGAACAACTG
CGTGAAACGATTCTCTCGT -> GTGAAACGATTCTCTCGTG
ATCCGCGCTTTCTGAAGCT -> TCCGCGCTTTCTGAAGCTC
GTGGGCTGGATTCCCCCGG -> TGGGCTGGATTCCCCCGGG
GTTAGCCCAGTTGCATACT -> TTAGCCCAGTTGCATACTG
GAGTCGAGGTAGTACCCCT -> AGTCGAGGTAGTACCCCTA
TGAAACGATTCTCTCGTGG -> GAAACGATTCTCTCGTGGT
CGTTTGGGAAATTTTACCT -> GTTTGGGAAATTTTACCTA
GTAAGTGTTAGGGGCTCCA -> TAAGTGTTAGGGGCTCCAA
CCGCTCCGGCAAATACAAA -> CGCTCCGGCAAATACAAAG
ATCCTTCACCGTCGTCTGT -> TCCTTCACCGTCGTCTGTC
AGCTACAACCGTCTTTGAG -> GCTACAACCGTCTTTGAGC
TCTATGTTAGCCCAGTTGC -> CTATGTTAGCCCAGTTGCA
CACCATAGCAACATCGAGC -> ACCATAGCAACATCGAGCC
ATGGCGAGTCTGGATCCGG -> TGGCGAGTCTGGATCCGGA
CCACCATAGCAACATCGAG -> CACCATAGCAACATCGAGC
CGCACTTCTGAATCCGCGC -> GCACTTCTGAATCCGCGCT
TTGGCAAGCTGACTCGAAT -> TGGCAAGCTGACTCGAATA
ACAATGGTAGGTTGAATCA -> CAATGGTAGGTTGAATCAT
TGCGCGGCTCTTGGAAGCG -> GCGCGGCTCTTGGAAGCGC
CTAAGAATCCGTACAATCC -> TAAGAATCCGTACAATCCT
ACAATTTCATGTGGGCTGG -> CAATTTCATGTGGGCTGGA
GATCTGGAAATCTTCTGTG -> ATCTGGAAATCTTCTGTGG
AAGCGCCCAACTAACCAGC -> AGCGCCCAACTAACCAGCT
TATATGGAAAACTAAATTG -> ATATGGAAAACTAAATTGA
GGAACTTATCATAATCTTA -> GAACTTATCATAATCTTAC
AGTCTGGATCCGGACTTTG -> GTCTGGATCCGGACTTTGA
CTGATTCGGGCATCGCACC -> TGATTCGGGCATCGCACCA
TATCGCATCAGTTAGGCAC -> ATCGCATCAGTTAGGCACT
GAATACCATAATGAGTCTA -> AATACCATAATGAGTCTAT
TACTCTTCCCCAAATACGT -> ACTCTTCCCCAAATACGTG
TGCGGTTCTTAAGTAGGAA -> GCGGTTCTTAAGTAGGAAC
ATACGTGCGAAATGAACAA -> TACGTGCGAAATGAACAAC
CCAGTGAGCAGGTTCGCTG -> CAGTGAGCAGGTTCGCTGA
CACAATGCGTCAGAGAGAG -> ACAATGCGTCAGAGAGAGC
AAACAGACATCGCCGAGGA -> AACAGACATCGCCGAGGAC
CTCTCGTGGTTCCAAGGTA -> TCTCGTGGTTCCAAGGTAT
GCACCTAATGGCGAGTCTG -> CACCTAATGGCGAGTCTGG
ATCGAGCGAATTCTCTTCT -> TCGAGCGAATTCTCTTCTT
GGATGACTTAGCGAATTGC -> GATGACTTAGCGAATTGCC
CAAAGGAAACGATTCTCTC -> AAAGGAAACGATTCTCTCG
GACATTGCTTACGAGATCG -> ACATTGCTTACGAGATCGA
CGCCGAGGACACTTACCTC -> GCCGAGGACACTTACCTCG
TGGCGAGTCTGGATCCGGA -> GGCGAGTCTGGATCCGGAC
GTTGGGATTAAACACTAGG -> TTGGGATTAAACACTAGGC
TACAAATGTCCGCTCCGGC -> ACAAATGTCCGCTCCGGCA
TCATTATCGACGTGTAACC -> CATTATCGACGTGTAACCG
ACCTAGCTAGCCGGTGAGA -> CCTAGCTAGCCGGTGAGAC
CTGGTCCGCTTTCAACCTA -> TGGTCCGCTTTCAACCTAA
TATAATACGTTATCGGCAC -> ATAATACGTTATCGGCACG
CTTCATCCACAGGAGGAAC -> TTCATCCACAGGAGGAACC
CTCCTCCCCTCTATTGCCG -> TCCTCCCCTCTATTGCCGC
CCGGTGAGACTACGAGAAA -> CGGTGAGACTACGAGAAAA
TTACCGAATAAATTGACCA -> TACCGAATAAATTGACCAT
CAACATCGAGCCGTCGATT -> AACATCGAGCCGTCGATTG
CTGCTATAATTCTAACTGC -> TGCTATAATTCTAACTGCT
AGGTATCCGTCCCGCCCGT -> GGTATCCGTCCCGCCCGTG
TACTGATAAAGCGGGCTGG -> ACTGATAAAGCGGGCTGGC
CGATTTGCGCAATAGGAGC -> GATTTGCGCAATAGGAGCC
AAAGACCAGCGCGTAATCC -> AAGACCAGCGCGTAATCCG
CCCAATTGAAAAGCACTAG -> CCAATTGAAAAGCACTAGT
CTATTGCCGCAAACAGACA -> TATTGCCGCAAACAGACAT
AGCGGTCTGGCACTTCTAA -> GCGGTCTGGCACTTCTAAG
AAGCGACCTATTCTAGTAC -> AGCGACCTATTCTAGTACT
TTGTTAAATTGAGGTATCC -> TGTTAAATTGAGGTATCCG
GGCGAGTCTGGATCCGGAC -> GCGAGTCTGGATCCGGACT
TACAATCCTTCCTGCAGCG -> ACAATCCTTCCTGCAGCGC
CGAGGCGGAGATAGCGTGA -> GAGGCGGAGATAGCGTGAC
GTTCCATCCAAACAACGGA -> TTCCATCCAAACAACGGAT
TGCGATTGTATGCCCTCCA -> GCGATTGTATGCCCTCCAG
TCCTCCCCTCTATTGCCGC -> CCTCCCCTCTATTGCCGCA
CCTAAGCGACCTATTCTAG -> CTAAGCGACCTATTCTAGT
GAGCAGGTTCGCTGATTCG -> AGCAGGTTCGCTGATTCGG
TGATTCGGGCATCGCACCA -> GATTCGGGCATCGCACCAA
ACCAGCTACCTAAAGGCAA -> CCAGCTACCTAAAGGCAAA
ATCCGGACTTTGATGGCGT -> TCCGGACTTTGATGGCGTT
GTAAGCAGCGCATTCATTA -> TAAGCAGCGCATTCATTAT
GCGCTGCCCATGCTGGGCG -> CGCTGCCCATGCTGGGCGT
TTTCCACATTATGGCCGTG -> TTCCACATTATGGCCGTGA
TAGGGGCTCCAAAGTCGTG -> AGGGGCTCCAAAGTCGTGC
TCCGCTCCGGCAAACCGCC -> CCGCTCCGGCAAACCGCCG
CCCCCGGGCAAGACCAACG -> CCCCGGGCAAGACCAACGC
AGCGCGTAATCCGAAAGTG -> GCGCGTAATCCGAAAGTGA
TACTACAACAGACCGCACC -> ACTACAACAGACCGCACCG
TGCCGAAAATAAACGTCGG -> GCCGAAAATAAACGTCGGA
ATGATCCTTCACCGTCGTC -> TGATCCTTCACCGTCGTCT
TGAACGCGATTTGCGCAAT -> GAACGCGATTTGCGCAATA
TTGACATTGCTTACGAGAT -> TGACATTGCTTACGAGATC
AACAGACCGCACCGTTTGG -> ACAGACCGCACCGTTTGGG
TCGATTGTCCTTCATCCAC -> CGATTGTCCTTCATCCACA
TTTGACATTGCTTACGAGA -> TTGACATTGCTTACGAGAT
CTGTCAATCGGCCCCCCAT -> TGTCAATCGGCCCCCCATC
GATTCACACCGCGATTCTC -> ATTCACACCGCGATTCTCT
GTTATGTACGGCTAAGAAT -> TTATGTACGGCTAAGAATC
GGTATAGTAAGCAGCGCAT -> GTATAGTAAGCAGCGCATT
TCTCGTGGTTCCATCCAAA -> CTCGTGGTTCCATCCAAAC
GAAATCTTCTGTGGGCGGC -> AAATCTTCTGTGGGCGGCA
TAAATTGACCATCTATTGT -> AAATTGACCATCTATTGTT
GTATATGATTTCATTCCCG -> TATATGATTTCATTCCCGT
AGATCGAGCGAATTCTCTT -> GATCGAGCGAATTCTCTTC
CCGGACTTTGATGGCGTTA -> CGGACTTTGATGGCGTTAA
CACCACCATAGCAACATCG -> ACCACCATAGCAACATCGA
TGAGCAGCGTGCCGTTATG -> GAGCAGCGTGCCGTTATGT
GTTCCACAATGGTAGGTTG -> TTCCACAATGGTAGGTTGA
GTTTGGGAAATTTTACCTA -> TTTGGGAAATTTTACCTAG
CGATTCTCTCGTGGTTCCA -> GATTCTCTCGTGGTTCCAA,GATTCTCTCGTGGTTCCAA,GATTCTCTCGTGGTTCCAT,GATTCTCTCGTGGTTCCAC
CACAATGGTAGGTTGAATC -> ACAATGGTAGGTTGAATCA
CGCTAAGTCCTGCCGAGGA -> GCTAAGTCCTGCCGAGGAG
CAATTCGAATGTCCGCTCC -> AATTCGAATGTCCGCTCCG
AGTCTGCGATTGTATGCCC -> GTCTGCGATTGTATGCCCT
CCCCATGATCCTTCACCGT -> CCCATGATCCTTCACCGTC
AGGAGACTGGTTTGCAACT -> GGAGACTGGTTTGCAACTA
TACGTGCGAAATGAACAAC -> ACGTGCGAAATGAACAACT
GCAGCATTCATCGTGTTTT -> CAGCATTCATCGTGTTTTG
AACAACTGTCTGCTGATCG -> ACAACTGTCTGCTGATCGA
TAATGAGTCTATGGGGTGT -> AATGAGTCTATGGGGTGTC
GTTTCATATCCTAAGACGC -> TTTCATATCCTAAGACGCA
GCCCCCCATCGTGTCCAGA -> CCCCCCATCGTGTCCAGAA
AAGAGTTGAGTCGAGGTAG -> AGAGTTGAGTCGAGGTAGT
ATGTCCGCTCCGGCAAAGA -> TGTCCGCTCCGGCAAAGAT
GTTTGGGCCTATAATACGT -> TTTGGGCCTATAATACGTT
TACCTCGAGGCGGAGATAG -> ACCTCGAGGCGGAGATAGC
ACCGCCGTGAAACGATTCT -> CCGCCGTGAAACGATTCTC
GCTTTCAACCTAAGCGACC -> CTTTCAACCTAAGCGACCT
TCCTCACTGGTCCGCTTTC -> CCTCACTGGTCCGCTTTCA
AGCTCCTTTGGCTATGGTA -> GCTCCTTTGGCTATGGTAA
GCTCGCTAGCGCATCCACT -> CTCGCTAGCGCATCCACTT
CATCCACTTTTGACATTGC -> ATCCACTTTTGACATTGCT
GTCTCACGCAGTCTGCGAT -> TCTCACGCAGTCTGCGATT
GAAATTACAAATGTCCGCT -> AAATTACAAATGTCCGCTC
CCGTACTTGATAACACTAT -> CGTACTTGATAACACTATG
ATGTTATCGCATCAGTTAG -> TGTTATCGCATCAGTTAGG
GTGTCTCACGCAGTCTGCG -> TGTCTCACGCAGTCTGCGA
CAAGTTACCGAATAAATTG -> AAGTTACCGAATAAATTGA
ACGAGAAAAGCAATTTGCG -> CGAGAAAAGCAATTTGCGG
CTAGTACTGCCAACTTTAC -> TAGTACTGCCAACTTTACG
TTCTTCTCCTACAATTCGA -> TCTTCTCCTACAATTCGAA
CCCATGCTGGGCGTGAAAT -> CCATGCTGGGCGTGAAATT
TTAAACACTAGGCACAATT -> TAAACACTAGGCACAATTT
GCTACAACCGTCTTTGAGC -> CTACAACCGTCTTTGAGCT
ACCACCATAGCAACATCGA -> CCACCATAGCAACATCGAG
CGGCATTGTCCCTGAGATT -> GGCATTGTCCCTGAGATTC
CATCGGCCCTACTGATAAA -> ATCGGCCCTACTGATAAAG
TAGGAACTACACTTCCATC -> AGGAACTACACTTCCATCA
TTGCAACTATGCATTGGGC -> TGCAACTATGCATTGGGCC
GTTGGCAAGCTGACTCGAA -> TTGGCAAGCTGACTCGAAT
TTGCCTAAATAGCCATTTA -> TGCCTAAATAGCCATTTAT
GTCCCGCCCGTGTTGGCAA -> TCCCGCCCGTGTTGGCAAG
GTGGTTCCAAGGTATAGTA -> TGGTTCCAAGGTATAGTAA
AACAACGGATCTGGAAATC -> ACAACGGATCTGGAAATCT
CAGACCGCACCGTTTGGGA -> AGACCGCACCGTTTGGGAA
TAATCCGAAAGTGAGGATG -> AATCCGAAAGTGAGGATGA
TCGCGCTACTCTCATCGGC -> CGCGCTACTCTCATCGGCC
CCGAGGACACTTACCTCGA -> CGAGGACACTTACCTCGAG
AGCGCTGCCCATGCTGGGC -> GCGCTGCCCATGCTGGGCG
CTCGTGGTTCCACAATGGT -> TCGTGGTTCCACAATGGTA
GGATTCCCCCGGGCAAGAC -> GATTCCCCCGGGCAAGACC
ATCCGAAAGTGAGGATGAC -> TCCGAAAGTGAGGATGACT
TAAAGCGGGCTGGCCTCCT -> AAAGCGGGCTGGCCTCCTC
GATGGCGTTAAGCAGGATT -> ATGGCGTTAAGCAGGATTT
CCCCCATCGTGTCCAGAAT -> CCCCATCGTGTCCAGAATA
TTCCTGCAGCGCTGCCCAT -> TCCTGCAGCGCTGCCCATG
CTCAAGTATCAAGTTACCG -> TCAAGTATCAAGTTACCGA
TGGGCCTACTATCCCTCTG -> GGGCCTACTATCCCTCTGT
TTTTGCTCGCTAGCGCATC -> TTTGCTCGCTAGCGCATCC
GTGTTTTGCTCGCTAGCGC -> TGTTTTGCTCGCTAGCGCA
AAAACTAAATTGAAATGGA -> AAACTAAATTGAAATGGAT
ATCGTAAAAGCGGTCTGGC -> TCGTAAAAGCGGTCTGGCA
GGTCTGGCACTTCTAAGAA -> GTCTGGCACTTCTAAGAAT
TATCCCTCTGTTTATCCCC -> ATCCCTCTGTTTATCCCCG
AAGCAATTTGCGGTTCTTA -> AGCAATTTGCGGTTCTTAA
TACAAAGGAAACGATTCTC -> ACAAAGGAAACGATTCTCT
AATAGTCTTAGGGCGAATC -> ATAGTCTTAGGGCGAATCC
CTCACGCAGTCTGCGATTG -> TCACGCAGTCTGCGATTGT
GCTATAATTCTAACTGCTA -> CTATAATTCTAACTGCTAG
CCATGATCCTTCACCGTCG -> CATGATCCTTCACCGTCGT
GCACTTCTAAGAATGAGCT -> CACTTCTAAGAATGAGCTT
AAATTGAAATGGATGTTAT -> AATTGAAATGGATGTTATC
GTGGTTCCATCCAAACAAC -> TGGTTCCATCCAAACAACG
ATAGCAACATCGAGCCGTC -> TAGCAACATCGAGCCGTCG
CCGTAATTGGATTCTCGAA -> CGTAATTGGATTCTCGAAG
GAGCGCTAAGTCCTGCCGA -> AGCGCTAAGTCCTGCCGAG
CGTTAAGCAGGATTTCGCG -> GTTAAGCAGGATTTCGCGC
GTGACTGAGCAGCGTGCCG -> TGACTGAGCAGCGTGCCGT
CGAGGAGACTCTTGCTGCC -> GAGGAGACTCTTGCTGCCG
ACCCCCATGATCCTTCACC -> CCCCCATGATCCTTCACCG
TAAGTAGGAACTACACTTC -> AAGTAGGAACTACACTTCC
ATTCGGGCATCGCACCAAC -> TTCGGGCATCGCACCAACC
ATGCTGGGCGTGAAATTAC -> TGCTGGGCGTGAAATTACA
TTGAATCATAGCCTGTCTG -> TGAATCATAGCCTGTCTGT
GGCATCGCACCAACCTAAG -> GCATCGCACCAACCTAAGG
CCCGTAATTGGATTCTCGA -> CCGTAATTGGATTCTCGAA
TAGCGTTACGATAGGAGAC -> AGCGTTACGATAGGAGACG
GCGCATCCACTTTTGACAT -> CGCATCCACTTTTGACATT
AGGCACTGCTATAATTCTA -> GGCACTGCTATAATTCTAA
ATAAAGCGGGCTGGCCTCC -> TAAAGCGGGCTGGCCTCCT
GCCCTCCAGGAGACTGGTT -> CCCTCCAGGAGACTGGTTT
GCCGTTGAGACACCCAAAT -> CCGTTGAGACACCCAAATA
TAGCCATTTATTTTTCCAC -> AGCCATTTATTTTTCCACA
GGGCCTATAATACGTTATC -> GGCCTATAATACGTTATCG
TGCATTGGGCCTACTATCC -> GCATTGGGCCTACTATCCC
TGGATTCTCGAAGCGATCC -> GGATTCTCGAAGCGATCCG
TCTTGGAAGCGCCCAACTA -> CTTGGAAGCGCCCAACTAA
CGGAACTTATCATAATCTT -> GGAACTTATCATAATCTTA
TATGCCCTCCAGGAGACTG -> ATGCCCTCCAGGAGACTGG
TCCCGCCCGTGTTGGCAAG -> CCCGCCCGTGTTGGCAAGC
CCGTTGAGACACCCAAATA -> CGTTGAGACACCCAAATAG
GCATAGCTATGTTTCGGGA -> CATAGCTATGTTTCGGGAC
AAAAGCAATTTGCGGTTCT -> AAAGCAATTTGCGGTTCTT
ACAGACCGCACCGTTTGGG -> CAGACCGCACCGTTTGGGA
CTCGTGGTTCCAATAATGA -> TCGTGGTTCCAATAATGAG
AATAGTACACTTCCATGGC -> ATAGTACACTTCCATGGCC
TTTTTCCACATTATGGCCG -> TTTTCCACATTATGGCCGT
GACTCGAATAGTCGATACT -> ACTCGAATAGTCGATACTG
AGGTTCGCTGATTCGGGCA -> GGTTCGCTGATTCGGGCAT
AACCTGGGGATCGTAAAAG -> ACCTGGGGATCGTAAAAGC
ACTTTGATGGCGTTAAGCA -> CTTTGATGGCGTTAAGCAG
CATTATGGCCGTGACTCAA -> ATTATGGCCGTGACTCAAG
ACTATCCCTCTGTTTATCC -> CTATCCCTCTGTTTATCCC
CTTACGCGGCATTGTCCCT -> TTACGCGGCATTGTCCCTG
CGCTGCCCATGCTGGGCGT -> GCTGCCCATGCTGGGCGTG
CCAGCTACCTAAAGGCAAA -> CAGCTACCTAAAGGCAAAG
ATAATACGTTATCGGCACG -> TAATACGTTATCGGCACGT
GGGCTGGATTCCCCCGGGC -> GGCTGGATTCCCCCGGGCA
CTGAGCAGCGTGCCGTTAT -> TGAGCAGCGTGCCGTTATG
ACCCAAATAGTCTTAGGGC -> CCCAAATAGTCTTAGGGCG
AGTTAGGCACTGCTATAAT -> GTTAGGCACTGCTATAATT
TGGTTTGCAACTATGCATT -> GGTTTGCAACTATGCATTG
CAAACGAGTACTCTTCCCC -> AAACGAGTACTCTTCCCCA
TAGCAACATCGAGCCGTCG -> AGCAACATCGAGCCGTCGA
TCCTAGCGAGCTGTGCGCG -> CCTAGCGAGCTGTGCGCGG
TGACTTAGCGAATTGCCTA -> GACTTAGCGAATTGCCTAA
CGGGCATCGCACCAACCTA -> GGGCATCGCACCAACCTAA
CACTGGTCCGCTTTCAACC -> ACTGGTCCGCTTTCAACCT
TTCATCCTAGCGAGCTGTG -> TCATCCTAGCGAGCTGTGC
TTAGGGGCTCCAAAGTCGT -> TAGGGGCTCCAAAGTCGTG
TGGCCTCCTCCCCTCTATT -> GGCCTCCTCCCCTCTATTG
GGTTCTTAAGTAGGAACTA -> GTTCTTAAGTAGGAACTAC
TGGTCCACTAGCTACAACC -> GGTCCACTAGCTACAACCG
GATCCGATGAAGATCCAAT -> ATCCGATGAAGATCCAATC
AGGCAAAGACCAGCGCGTA -> GGCAAAGACCAGCGCGTAA
AATTACAAATGTCCGCTCC -> ATTACAAATGTCCGCTCCG
CCGCGTGATGGTCCACTAG -> CGCGTGATGGTCCACTAGC
CAGTTAGGCACTGCTATAA -> AGTTAGGCACTGCTATAAT
ACTAAATTGAAATGGATGT -> CTAAATTGAAATGGATGTT
GGCCCCCCATCGTGTCCAG -> GCCCCCCATCGTGTCCAGA
GCGACCTATTCTAGTACTG -> CGACCTATTCTAGTACTGC
CACCGTTTGGGAAATTTTA -> ACCGTTTGGGAAATTTTAC
ACTTAGCGAATTGCCTAAA -> CTTAGCGAATTGCCTAAAT
GTCATCCCGCGTGATGGTC -> TCATCCCGCGTGATGGTCC
ACAATGCGTCAGAGAGAGC -> CAATGCGTCAGAGAGAGCG
CTCTGTTTATCCCCGTAAT -> TCTGTTTATCCCCGTAATT
CGAATCCAGTATATGATTT -> GAATCCAGTATATGATTTC
AATCGCTGTACACAGTTCG -> ATCGCTGTACACAGTTCGC
ATGGTAATGTCCGCTCCGG -> TGGTAATGTCCGCTCCGGC
GACTCAAGTATCAAGTTAC -> ACTCAAGTATCAAGTTACC
CCGTGTTGGCAAGCTGACT -> CGTGTTGGCAAGCTGACTC
CAGCTACCTAAAGGCAAAG -> AGCTACCTAAAGGCAAAGA
ATCGCTGTACACAGTTCGC -> TCGCTGTACACAGTTCGCA
ATTCTAACTGCTAGGCATA -> TTCTAACTGCTAGGCATAC
GGCACGTTAGCCCGGCATA -> GCACGTTAGCCCGGCATAG
AGCGAATTGCCTAAATAGC -> GCGAATTGCCTAAATAGCC
CATCGAGCCGTCGATTGTC -> ATCGAGCCGTCGATTGTCC
AGCTGACTCGAATAGTCGA -> GCTGACTCGAATAGTCGAT
TGGGCGTGAAATTACAAAT -> GGGCGTGAAATTACAAATG
GCCGGTGAGACTACGAGAA -> CCGGTGAGACTACGAGAAA
TGTGGGCTGGATTCCCCCG -> GTGGGCTGGATTCCCCCGG
CAAACCGCCGTGAAACGAT -> AAACCGCCGTGAAACGATT
CGCTCCGCATGAGTAATAT -> GCTCCGCATGAGTAATATA
TATTTTTCCACATTATGGC -> ATTTTTCCACATTATGGCC
GGAGGAACCTGGGGATCGT -> GAGGAACCTGGGGATCGTA
AGCAATTTGCGGTTCTTAA -> GCAATTTGCGGTTCTTAAG
CGGCTAAGAATCCGTACAA -> GGCTAAGAATCCGTACAAT
AGACTGGTTTGCAACTATG -> GACTGGTTTGCAACTATGC
CCTAAATAGCCATTTATTT -> CTAAATAGCCATTTATTTT
CAATCGGCCCCCCATCGTG -> AATCGGCCCCCCATCGTGT
ACAACGGATCTGGAAATCT -> CAACGGATCTGGAAATCTT
GCTGGATTCCCCCGGGCAA -> CTGGATTCCCCCGGGCAAG
TGGGCGGCAGCAGCATTCA -> GGGCGGCAGCAGCATTCAT
GCGCAATAGGAGCCGCCTT -> CGCAATAGGAGCCGCCTTA
AAGCGATCCGATGAAGATC -> AGCGATCCGATGAAGATCC
GTACCCCTATATTCGTCAT -> TACCCCTATATTCGTCATC
TCACTGGTCCGCTTTCAAC -> CACTGGTCCGCTTTCAACC
TAGTGACTGAGCAGCGTGC -> AGTGACTGAGCAGCGTGCC
AACACTAGGCACAATTTCA -> ACACTAGGCACAATTTCAT
TCGGAACTTATCATAATCT -> CGGAACTTATCATAATCTT
TATGGGGTGTCTCACGCAG -> ATGGGGTGTCTCACGCAGT
GCTTTCTGAAGCTCCTTTG -> CTTTCTGAAGCTCCTTTGG
CAAATAGTCTTAGGGCGAA -> AAATAGTCTTAGGGCGAAT
CAGGTTCGCTGATTCGGGC -> AGGTTCGCTGATTCGGGCA
CGCTGTACACAGTTCGCAG -> GCTGTACACAGTTCGCAGA
ATTGCCTAAATAGCCATTT -> TTGCCTAAATAGCCATTTA
GCAAACGAGTACTCTTCCC -> CAAACGAGTACTCTTCCCC
TGCCTAAATAGCCATTTAT -> GCCTAAATAGCCATTTATT
TAAGCGACCTATTCTAGTA -> AAGCGACCTATTCTAGTAC
GTTAGGCACTGCTATAATT -> TTAGGCACTGCTATAATTC
CCTAATGGCGAGTCTGGAT -> CTAATGGCGAGTCTGGATC
TAACACTATGTTCCCCGCA -> AACACTATGTTCCCCGCAA
GAGATCGAGCGAATTCTCT -> AGATCGAGCGAATTCTCTT
TTTCGCGCTACTCTCATCG -> TTCGCGCTACTCTCATCGG
AAAGCACTAGTGACTGAGC -> AAGCACTAGTGACTGAGCA
AAGGTATAGTAAGCAGCGC -> AGGTATAGTAAGCAGCGCA
GAAATGAACAACTGTCTGC -> AAATGAACAACTGTCTGCT
GCATTGTCCCTGAGATTCT -> CATTGTCCCTGAGATTCTG
TATCAAGTTACCGAATAAA -> ATCAAGTTACCGAATAAAT
TGGTTCCACAATGGTAGGT -> GGTTCCACAATGGTAGGTT
GAATCCGTACAATCCTTCC -> AATCCGTACAATCCTTCCT
GTAATATAAGAGTTGAGTC -> TAATATAAGAGTTGAGTCG
TCGCATCAGTTAGGCACTG -> CGCATCAGTTAGGCACTGC
CCCCGGGCAAGACCAACGC -> CCCGGGCAAGACCAACGCT
TTCGGGACCCGTACTTGAT -> TCGGGACCCGTACTTGATA
GCGATTTGCGCAATAGGAG -> CGATTTGCGCAATAGGAGC
TGGTCCGCTTTCAACCTAA -> GGTCCGCTTTCAACCTAAG
TCCTTCATCCACAGGAGGA -> CCTTCATCCACAGGAGGAA
CATTTATTTTTCCACATTA -> ATTTATTTTTCCACATTAT
ATCGGCCCTACTGATAAAG -> TCGGCCCTACTGATAAAGC
TGTGGGCGGCAGCAGCATT -> GTGGGCGGCAGCAGCATTC
TAGGGCGAATCCAGTATAT -> AGGGCGAATCCAGTATATG
TCGTGGTTCCATCCAAACA -> CGTGGTTCCATCCAAACAA
CACTATGTTCCCCGCAAAC -> ACTATGTTCCCCGCAAACG
ATTTCATGTGGGCTGGATT -> TTTCATGTGGGCTGGATTC
GGCGGCAGCAGCATTCATC -> GCGGCAGCAGCATTCATCG
AGATTCTGCCCTGACCCAA -> GATTCTGCCCTGACCCAAT
CCGTTTGGGAAATTTTACC -> CGTTTGGGAAATTTTACCT
AAGGCAAAGACCAGCGCGT -> AGGCAAAGACCAGCGCGTA
AGGTGGAGCCGTTGAGACA -> GGTGGAGCCGTTGAGACAC
CATCGTGTCCAGAATACCA -> ATCGTGTCCAGAATACCAT
CGGCGGACGATTCTCTCGT -> GGCGGACGATTCTCTCGTG
CTTACCTCGAGGCGGAGAT -> TTACCTCGAGGCGGAGATA
GCAGCGCATTCATTATCGA -> CAGCGCATTCATTATCGAC
TCTTAAGTAGGAACTACAC -> CTTAAGTAGGAACTACACT
TTTCATTCCCGTCTATGTT -> TTCATTCCCGTCTATGTTA
TTCTTAAGTAGGAACTACA -> TCTTAAGTAGGAACTACAC
TCAACCTAAGCGACCTATT -> CAACCTAAGCGACCTATTC
TCCCCTCTATTGCCGCAAA -> CCCCTCTATTGCCGCAAAC
CGTCTATGTTAGCCCAGTT -> GTCTATGTTAGCCCAGTTG
GGATCCGGACTTTGATGGC -> GATCCGGACTTTGATGGCG
GCAAGCTGACTCGAATAGT -> CAAGCTGACTCGAATAGTC
GCTCCGGCAAAAACCCGGC -> CTCCGGCAAAAACCCGGCG
AGCTCATATTTTTACACGA -> GCTCATATTTTTACACGAT
ATAATCTTACGCGGCATTG -> TAATCTTACGCGGCATTGT
AACTTATCATAATCTTACG -> ACTTATCATAATCTTACGC
GTCGATACTGCCGAGTACG -> TCGATACTGCCGAGTACGC
GGGCTCCAAAGTCGTGCAC -> GGCTCCAAAGTCGTGCACC
CAGCATTCATCGTGTTTTG -> AGCATTCATCGTGTTTTGC
CAAAGATTCACACCGCGAT -> AAAGATTCACACCGCGATT
TGTTAAATTGAGGTATCCG -> GTTAAATTGAGGTATCCGT
TACTCTCATCGGCCCTACT -> ACTCTCATCGGCCCTACTG
AGTAGGAACTACACTTCCA -> GTAGGAACTACACTTCCAT
GGCACAATTTCATGTGGGC -> GCACAATTTCATGTGGGCT
CGCGGCATTGTCCCTGAGA -> GCGGCATTGTCCCTGAGAT
CAAAGTCGTGCACCTAATG -> AAAGTCGTGCACCTAATGG
GAGACTCTTGCTGCCGAAA -> AGACTCTTGCTGCCGAAAA
ATCGCACCAACCTAAGGAC -> TCGCACCAACCTAAGGACC
CTTAGGGCGAATCCAGTAT -> TTAGGGCGAATCCAGTATA
CCGGCAAAGATTCACACCG -> CGGCAAAGATTCACACCGC
AATGTCCGCTCCGGCAAAC -> ATGTCCGCTCCGGCAAACC
CTTAGCGTTACGATAGGAG -> TTAGCGTTACGATAGGAGA
TTCTAGTACTGCCAACTTT -> TCTAGTACTGCCAACTTTA
TATTCGTCATCCCGCGTGA -> ATTCGTCATCCCGCGTGAT
TCATTCCCGTCTATGTTAG -> CATTCCCGTCTATGTTAGC
AGAAAAGCAATTTGCGGTT -> GAAAAGCAATTTGCGGTTC
AATAGGAGCCGCCTTAGCG -> ATAGGAGCCGCCTTAGCGT
GTACCCCCATGATCCTTCA -> TACCCCCATGATCCTTCAC
CATAATCTTACGCGGCATT -> ATAATCTTACGCGGCATTG
GATTCGGGCATCGCACCAA -> ATTCGGGCATCGCACCAAC
TCTTGCTGCCGAAAATAAA -> CTTGCTGCCGAAAATAAAC
CCCAAATACGTGCGAAATG -> CCAAATACGTGCGAAATGA
TAGCTACAACCGTCTTTGA -> AGCTACAACCGTCTTTGAG
AAAGCAATTTGCGGTTCTT -> AAGCAATTTGCGGTTCTTA
TATCCTAAGACGCACTTCT -> ATCCTAAGACGCACTTCTG
ATTCTAGTACTGCCAACTT -> TTCTAGTACTGCCAACTTT
GACGTGTAACCGTTGTAAG -> ACGTGTAACCGTTGTAAGT
AATTGACCATCTATTGTTA -> ATTGACCATCTATTGTTAA
ACTTTTGACATTGCTTACG -> CTTTTGACATTGCTTACGA
CAAGTATCAAGTTACCGAA -> AAGTATCAAGTTACCGAAT
CATTCCCGTCTATGTTAGC -> ATTCCCGTCTATGTTAGCC
CTAGCGAGCTGTGCGCGGC -> TAGCGAGCTGTGCGCGGCT
AATGAGAACACAATGCGTC -> ATGAGAACACAATGCGTCA
TTAGCCCAGTTGCATACTG -> TAGCCCAGTTGCATACTGG
ACATCGCCGAGGACACTTA -> CATCGCCGAGGACACTTAC
ACGCTCCGCATGAGTAATA -> CGCTCCGCATGAGTAATAT
GATCGTAAAAGCGGTCTGG -> ATCGTAAAAGCGGTCTGGC
AACCTAAGCGACCTATTCT -> ACCTAAGCGACCTATTCTA
CTACGAGAAAAGCAATTTG -> TACGAGAAAAGCAATTTGC
CAAAAACCCGGCGGACGAT -> AAAAACCCGGCGGACGATT
CGATGAAGATCCAATCGCT -> GATGAAGATCCAATCGCTG
AATAATGAGAACACAATGC -> ATAATGAGAACACAATGCG
TTACCTCGAGGCGGAGATA -> TACCTCGAGGCGGAGATAG
TGGGCTGGATTCCCCCGGG -> GGGCTGGATTCCCCCGGGC
CTCTCGTGGTTCCATCCAA -> TCTCGTGGTTCCATCCAAA
GCCTCCTCCCCTCTATTGC -> CCTCCTCCCCTCTATTGCC
GTTTATCCCCGTAATTGGA -> TTTATCCCCGTAATTGGAT
CGCGGCTCTTGGAAGCGCC -> GCGGCTCTTGGAAGCGCCC
GCAATTTGCGGTTCTTAAG -> CAATTTGCGGTTCTTAAGT
CTTGTTGGGATTAAACACT -> TTGTTGGGATTAAACACTA
CCTGGGGATCGTAAAAGCG -> CTGGGGATCGTAAAAGCGG
GACTTTGATGGCGTTAAGC -> ACTTTGATGGCGTTAAGCA
CACTTCTAAGAATGAGCTT -> ACTTCTAAGAATGAGCTTC
AGTCGTGCACCTAATGGCG -> GTCGTGCACCTAATGGCGA
TGCTATAATTCTAACTGCT -> GCTATAATTCTAACTGCTA
CGCATTCATTATCGACGTG -> GCATTCATTATCGACGTGT
CGTTGTAAGTGTTAGGGGC -> GTTGTAAGTGTTAGGGGCT
GACACTTACCTCGAGGCGG -> ACACTTACCTCGAGGCGGA
GGTTTGGGCCTATAATACG -> GTTTGGGCCTATAATACGT
TACACAGTTCGCAGATGAA -> ACACAGTTCGCAGATGAAC
GCTATGTTTCGGGACCCGT -> CTATGTTTCGGGACCCGTA
AACTTTACGTTTCATATCC -> ACTTTACGTTTCATATCCT
ACCGTTTGGGAAATTTTAC -> CCGTTTGGGAAATTTTACC
GATTTGCGCAATAGGAGCC -> ATTTGCGCAATAGGAGCCG
ATTAAACACTAGGCACAAT -> TTAAACACTAGGCACAATT
AATGGTAGGTTGAATCATA -> ATGGTAGGTTGAATCATAG
CTCTTCCCCAAATACGTGC -> TCTTCCCCAAATACGTGCG
AGCAGCATTCATCGTGTTT -> GCAGCATTCATCGTGTTTT
GAGGTAGTACCCCTATATT -> AGGTAGTACCCCTATATTC
ATAGTCTTAGGGCGAATCC -> TAGTCTTAGGGCGAATCCA
AAGATCCAATCGCTGTACA -> AGATCCAATCGCTGTACAC
GGCAAAGATTCACACCGCG -> GCAAAGATTCACACCGCGA
ACTCGAATAGTCGATACTG -> CTCGAATAGTCGATACTGC
GACTGGTTTGCAACTATGC -> ACTGGTTTGCAACTATGCA
CTTTACGTTTCATATCCTA -> TTTACGTTTCATATCCTAA
AGTTCGCAGATGAACGCGA -> GTTCGCAGATGAACGCGAT
GCAAAAACCCGGCGGACGA -> CAAAAACCCGGCGGACGAT
TGCCGAGTACGCGGGAGGT -> GCCGAGTACGCGGGAGGTG
CGAGGTAGTACCCCTATAT -> GAGGTAGTACCCCTATATT
TGATGGTCCACTAGCTACA -> GATGGTCCACTAGCTACAA
TAGCCTGTCTGTACCCCCA -> AGCCTGTCTGTACCCCCAT
AGGTTGAATCATAGCCTGT -> GGTTGAATCATAGCCTGTC
GGCATAGCTATGTTTCGGG -> GCATAGCTATGTTTCGGGA
ACAACAGACCGCACCGTTT -> CAACAGACCGCACCGTTTG
GGAGATAGCGTGACTTGTT -> GAGATAGCGTGACTTGTTG
CGTTACGATAGGAGACGCT -> GTTACGATAGGAGACGCTC
AAAATAAACGTCGGAACTT -> AAATAAACGTCGGAACTTA
AACAGACATCGCCGAGGAC -> ACAGACATCGCCGAGGACA
AAGAATCCGTACAATCCTT -> AGAATCCGTACAATCCTTC
TACTGCCAACTTTACGTTT -> ACTGCCAACTTTACGTTTC
ATGTCCGCTCCGGCAAAAA -> TGTCCGCTCCGGCAAAAAC
GTCCAGAATACCATAATGA -> TCCAGAATACCATAATGAG
CATTATCGACGTGTAACCG -> ATTATCGACGTGTAACCGT
GAGTCTGGATCCGGACTTT -> AGTCTGGATCCGGACTTTG
GTACGGCTAAGAATCCGTA -> TACGGCTAAGAATCCGTAC
GCCCTGACCCAATTGAAAA -> CCCTGACCCAATTGAAAAG
AATTTCATGTGGGCTGGAT -> ATTTCATGTGGGCTGGATT
TACCATAATGAGTCTATGG -> ACCATAATGAGTCTATGGG
TTAAGTAGGAACTACACTT -> TAAGTAGGAACTACACTTC
ACGCGGCATTGTCCCTGAG -> CGCGGCATTGTCCCTGAGA
TGACATTGCTTACGAGATC -> GACATTGCTTACGAGATCG
GCACTTCTGAATCCGCGCT -> CACTTCTGAATCCGCGCTT
CGAGCGAATTCTCTTCTTC -> GAGCGAATTCTCTTCTTCT
CAGCAGCATTCATCGTGTT -> AGCAGCATTCATCGTGTTT
TGAACAACTGTCTGCTGAT -> GAACAACTGTCTGCTGATC
TTGCGGTTCTTAAGTAGGA -> TGCGGTTCTTAAGTAGGAA
CGCGTGATGGTCCACTAGC -> GCGTGATGGTCCACTAGCT
ATCCTCACTGGTCCGCTTT -> TCCTCACTGGTCCGCTTTC
GGCAAGACCAACGCTAACA -> GCAAGACCAACGCTAACAC
TCTCACGCAGTCTGCGATT -> CTCACGCAGTCTGCGATTG
GAAGCGATCCGATGAAGAT -> AAGCGATCCGATGAAGATC
CGCTTTCAACCTAAGCGAC -> GCTTTCAACCTAAGCGACC
CCGCTCCGGCAAAAACCCG -> CGCTCCGGCAAAAACCCGG
GCTAAGTCCTGCCGAGGAG -> CTAAGTCCTGCCGAGGAGA
TTCCATCAATGTCCGCTCC -> TCCATCAATGTCCGCTCCG
CGAGAAAAGCAATTTGCGG -> GAGAAAAGCAATTTGCGGT
GCTCTTGGAAGCGCCCAAC -> CTCTTGGAAGCGCCCAACT
TGCCCTGACCCAATTGAAA -> GCCCTGACCCAATTGAAAA
CACTGCTATAATTCTAACT -> ACTGCTATAATTCTAACTG
TCATCCTAGCGAGCTGTGC -> CATCCTAGCGAGCTGTGCG
CTTTGATGGCGTTAAGCAG -> TTTGATGGCGTTAAGCAGG
TCCACAATGGTAGGTTGAA -> CCACAATGGTAGGTTGAAT
AGACTACGAGAAAAGCAAT -> GACTACGAGAAAAGCAATT
GCCGTCGATTGTCCTTCAT -> CCGTCGATTGTCCTTCATC
ACAACTGTCTGCTGATCGA -> CAACTGTCTGCTGATCGAA
CGTTTCATATCCTAAGACG -> GTTTCATATCCTAAGACGC
ACGCAGTCTGCGATTGTAT -> CGCAGTCTGCGATTGTATG
CTCTTGCTGCCGAAAATAA -> TCTTGCTGCCGAAAATAAA
CACCGTCGTCTGTCAATCG -> ACCGTCGTCTGTCAATCGG
GTTCCAAGGTATAGTAAGC -> TTCCAAGGTATAGTAAGCA
TGTTGGGATTAAACACTAG -> GTTGGGATTAAACACTAGG
CCCTCTATTGCCGCAAACA -> CCTCTATTGCCGCAAACAG
GGTTGAATCATAGCCTGTC -> GTTGAATCATAGCCTGTCT
AAACAACGGATCTGGAAAT -> AACAACGGATCTGGAAATC
GCTCCGCATGAGTAATATA -> CTCCGCATGAGTAATATAA
GTCTGTCAATCGGCCCCCC -> TCTGTCAATCGGCCCCCCA
TTCACACCGCGATTCTCTC -> TCACACCGCGATTCTCTCG
GCCGTTATGTACGGCTAAG -> CCGTTATGTACGGCTAAGA
CCTTACTACAACAGACCGC -> CTTACTACAACAGACCGCA
CTGCGATTGTATGCCCTCC -> TGCGATTGTATGCCCTCCA
GTTAAGCAGGATTTCGCGC -> TTAAGCAGGATTTCGCGCT
CTAGCTAGCCGGTGAGACT -> TAGCTAGCCGGTGAGACTA
GAATCCGCGCTTTCTGAAG -> AATCCGCGCTTTCTGAAGC
ATTCACACCGCGATTCTCT -> TTCACACCGCGATTCTCTC
CCCAACTAACCAGCTACCT -> CCAACTAACCAGCTACCTA
ATCCAAACAACGGATCTGG -> TCCAAACAACGGATCTGGA
ATGGTCCACTAGCTACAAC -> TGGTCCACTAGCTACAACC
ATACTGCCGAGTACGCGGG -> TACTGCCGAGTACGCGGGA
TCTCCTACAATTCGAATGT -> CTCCTACAATTCGAATGTC
TCCGGCAAACCGCCGTGAA -> CCGGCAAACCGCCGTGAAA
ATCGACGTGTAACCGTTGT -> TCGACGTGTAACCGTTGTA
CTGCAGCGCTGCCCATGCT -> TGCAGCGCTGCCCATGCTG
CATGGCCTTACTACAACAG -> ATGGCCTTACTACAACAGA
GCGGGAGGTGGAGCCGTTG -> CGGGAGGTGGAGCCGTTGA
CCTACTATCCCTCTGTTTA -> CTACTATCCCTCTGTTTAT
CATAGCAACATCGAGCCGT -> ATAGCAACATCGAGCCGTC
GTGCACCTAATGGCGAGTC -> TGCACCTAATGGCGAGTCT
GACACCCAAATAGTCTTAG -> ACACCCAAATAGTCTTAGG
ACCAATCCTCACTGGTCCG -> CCAATCCTCACTGGTCCGC
CTGCCCATGCTGGGCGTGA -> TGCCCATGCTGGGCGTGAA
AAATAAACGTCGGAACTTA -> AATAAACGTCGGAACTTAT
TCTGGATCCGGACTTTGAT -> CTGGATCCGGACTTTGATG
GCTGATTCGGGCATCGCAC -> CTGATTCGGGCATCGCACC
GACTTAGCGAATTGCCTAA -> ACTTAGCGAATTGCCTAAA
TTACGCGGCATTGTCCCTG -> TACGCGGCATTGTCCCTGA
ATAGCTATGTTTCGGGACC -> TAGCTATGTTTCGGGACCC
CCAAGGTATAGTAAGCAGC -> CAAGGTATAGTAAGCAGCG
TCCTTCACCGTCGTCTGTC -> CCTTCACCGTCGTCTGTCA
AATGGCGAGTCTGGATCCG -> ATGGCGAGTCTGGATCCGG
AGCAACATCGAGCCGTCGA -> GCAACATCGAGCCGTCGAT
TGTCCGCTCCGGCAAATAC -> GTCCGCTCCGGCAAATACA
CTACACTTCCATCAATGTC -> TACACTTCCATCAATGTCC
TTGATAACACTATGTTCCC -> TGATAACACTATGTTCCCC
AAGCGGGCTGGCCTCCTCC -> AGCGGGCTGGCCTCCTCCC
TGGTTCCAAGGTATAGTAA -> GGTTCCAAGGTATAGTAAG
CACAATTTCATGTGGGCTG -> ACAATTTCATGTGGGCTGG
CGATACTGCCGAGTACGCG -> GATACTGCCGAGTACGCGG
CCGGCATAGCTATGTTTCG -> CGGCATAGCTATGTTTCGG
CCCCAAATACGTGCGAAAT -> CCCAAATACGTGCGAAATG
TATGTTTCGGGACCCGTAC -> ATGTTTCGGGACCCGTACT
CCCGCCCGTGTTGGCAAGC -> CCGCCCGTGTTGGCAAGCT
AAGTGAGGATGACTTAGCG -> AGTGAGGATGACTTAGCGA
GTAAAAGCGGTCTGGCACT -> TAAAAGCGGTCTGGCACTT
AGATTCACACCGCGATTCT -> GATTCACACCGCGATTCTC
ATGAGTAATATAAGAGTTG -> TGAGTAATATAAGAGTTGA
CCGCTCCGGCAAAGATTCA -> CGCTCCGGCAAAGATTCAC
TGACTGAGCAGCGTGCCGT -> GACTGAGCAGCGTGCCGTT
AAATAGTCTTAGGGCGAAT -> AATAGTCTTAGGGCGAATC
TCGAGGTAGTACCCCTATA -> CGAGGTAGTACCCCTATAT
AAATTGACCATCTATTGTT -> AATTGACCATCTATTGTTA
TTGACCATCTATTGTTAAA -> TGACCATCTATTGTTAAAT
AATTGAGGTATCCGTCCCG -> ATTGAGGTATCCGTCCCGC
CACTTCCATCAATGTCCGC -> ACTTCCATCAATGTCCGCT
CATTGGGCCTACTATCCCT -> ATTGGGCCTACTATCCCTC
ACGAGATCGAGCGAATTCT -> CGAGATCGAGCGAATTCTC
CCGTCTTTGAGCTCATATT -> CGTCTTTGAGCTCATATTT
CTTTGGCTATGGTAATGTC -> TTTGGCTATGGTAATGTCC
TGAGCTTCATCCTAGCGAG -> GAGCTTCATCCTAGCGAGC
ACCGCGATTCTCTCGTGGT -> CCGCGATTCTCTCGTGGTT
AGGAGCCGCCTTAGCGTTA -> GGAGCCGCCTTAGCGTTAC
CCGTGACTCAAGTATCAAG -> CGTGACTCAAGTATCAAGT
AACGAGTACTCTTCCCCAA -> ACGAGTACTCTTCCCCAAA
TCGCTAGCGCATCCACTTT -> CGCTAGCGCATCCACTTTT
GGGCAAGACCAACGCTAAC -> GGCAAGACCAACGCTAACA
GTAATCCGAAAGTGAGGAT -> TAATCCGAAAGTGAGGATG
AGAGCGCTAAGTCCTGCCG -> GAGCGCTAAGTCCTGCCGA
TTTGCTCGCTAGCGCATCC -> TTGCTCGCTAGCGCATCCA
GCATGAGTAATATAAGAGT -> CATGAGTAATATAAGAGTT
GAACTTATCATAATCTTAC -> AACTTATCATAATCTTACG
CCTTTGGCTATGGTAATGT -> CTTTGGCTATGGTAATGTC
ACAACCGTCTTTGAGCTCA -> CAACCGTCTTTGAGCTCAT
TTCATTCCCGTCTATGTTA -> TCATTCCCGTCTATGTTAG
TCATCCCGCGTGATGGTCC -> CATCCCGCGTGATGGTCCA
CGGACTTTGATGGCGTTAA -> GGACTTTGATGGCGTTAAG
GCTATGGTAATGTCCGCTC -> CTATGGTAATGTCCGCTCC
GAGAACACAATGCGTCAGA -> AGAACACAATGCGTCAGAG
GGGGCTCCAAAGTCGTGCA -> GGGCTCCAAAGTCGTGCAC
GTGACTCAAGTATCAAGTT -> TGACTCAAGTATCAAGTTA
AATACCATAATGAGTCTAT -> ATACCATAATGAGTCTATG
AAGAATGAGCTTCATCCTA -> AGAATGAGCTTCATCCTAG
GGTATCCGTCCCGCCCGTG -> GTATCCGTCCCGCCCGTGT
CCGGCGGACGATTCTCTCG -> CGGCGGACGATTCTCTCGT
ACACCGCGATTCTCTCGTG -> CACCGCGATTCTCTCGTGG
ATAGCCATTTATTTTTCCA -> TAGCCATTTATTTTTCCAC
GTTGAGTCGAGGTAGTACC -> TTGAGTCGAGGTAGTACCC
ATATAAGAGTTGAGTCGAG -> TATAAGAGTTGAGTCGAGG
TAAATTGAGGTATCCGTCC -> AAATTGAGGTATCCGTCCC
CCTTCATCCACAGGAGGAA -> CTTCATCCACAGGAGGAAC
AAGGACCAATCCTCACTGG -> AGGACCAATCCTCACTGGT
TTAGCCCGGCATAGCTATG -> TAGCCCGGCATAGCTATGT
AAAAACCCGGCGGACGATT -> AAAACCCGGCGGACGATTC
GGTCCGCTTTCAACCTAAG -> GTCCGCTTTCAACCTAAGC
TCATATTTTTACACGATAG -> CATATTTTTACACGATAGC
GCTGGGCGTGAAATTACAA -> CTGGGCGTGAAATTACAAA
TTCTCTTCTTCTCCTACAA -> TCTCTTCTTCTCCTACAAT
TCCGGCAAATACAAAGGAA -> CCGGCAAATACAAAGGAAA
GCCAGTGAGCAGGTTCGCT -> CCAGTGAGCAGGTTCGCTG
ATAGCGTGACTTGTTGGGA -> TAGCGTGACTTGTTGGGAT
CGTCGTCTGTCAATCGGCC -> GTCGTCTGTCAATCGGCCC
CCAAAGTCGTGCACCTAAT -> CAAAGTCGTGCACCTAATG
CTACTCTCATCGGCCCTAC -> TACTCTCATCGGCCCTACT
TTCGCTGATTCGGGCATCG -> TCGCTGATTCGGGCATCGC
TTCCACATTATGGCCGTGA -> TCCACATTATGGCCGTGAC
CATAGCCTGTCTGTACCCC -> ATAGCCTGTCTGTACCCCC
TTCTCCTACAATTCGAATG -> TCTCCTACAATTCGAATGT
GACCAGCGCGTAATCCGAA -> ACCAGCGCGTAATCCGAAA
CGTGACTCAAGTATCAAGT -> GTGACTCAAGTATCAAGTT
GTTTCGGGACCCGTACTTG -> TTTCGGGACCCGTACTTGA
CCTACAATTCGAATGTCCG -> CTACAATTCGAATGTCCGC
CTACAATTCGAATGTCCGC -> TACAATTCGAATGTCCGCT
ACACAGTTCGCAGATGAAC -> CACAGTTCGCAGATGAACG
CGAAGCGATCCGATGAAGA -> GAAGCGATCCGATGAAGAT
TGCGAAATGAACAACTGTC -> GCGAAATGAACAACTGTCT
TGACTCGAATAGTCGATAC -> GACTCGAATAGTCGATACT
CGGTTCTTAAGTAGGAACT -> GGTTCTTAAGTAGGAACTA
ATCCACAGGAGGAACCTGG -> TCCACAGGAGGAACCTGGG
TAGTCGATACTGCCGAGTA -> AGTCGATACTGCCGAGTAC
CCATAATGAGTCTATGGGG -> CATAATGAGTCTATGGGGT
CTATGCATTGGGCCTACTA -> TATGCATTGGGCCTACTAT
GGAACCTGGGGATCGTAAA -> GAACCTGGGGATCGTAAAA
GCTCATATTTTTACACGAT -> CTCATATTTTTACACGATA
TAGCCCAGTTGCATACTGG -> AGCCCAGTTGCATACTGGT
GGTAGTACCCCTATATTCG -> GTAGTACCCCTATATTCGT
TTTATCCCCGTAATTGGAT -> TTATCCCCGTAATTGGATT
ATTCTCTTCTTCTCCTACA -> TTCTCTTCTTCTCCTACAA
TTATCCCCGTAATTGGATT -> TATCCCCGTAATTGGATTC
GCGTTACGATAGGAGACGC -> CGTTACGATAGGAGACGCT
CTACTATCCCTCTGTTTAT -> TACTATCCCTCTGTTTATC
CGAATGTCCGCTCCGGCAA -> GAATGTCCGCTCCGGCAAA
CCGCCGTGAAACGATTCTC -> CGCCGTGAAACGATTCTCT
CGTGACTTGTTGGGATTAA -> GTGACTTGTTGGGATTAAA
CTATCCCTCTGTTTATCCC -> TATCCCTCTGTTTATCCCC
CCATCAATGTCCGCTCCGG -> CATCAATGTCCGCTCCGGC
AATAAACGTCGGAACTTAT -> ATAAACGTCGGAACTTATC
GATAGCGTGACTTGTTGGG -> ATAGCGTGACTTGTTGGGA
CGCTCCGGCAAAAACCCGG -> GCTCCGGCAAAAACCCGGC
TTCCCCCGGGCAAGACCAA -> TCCCCCGGGCAAGACCAAC
ACTGCTATAATTCTAACTG -> CTGCTATAATTCTAACTGC
AAATAGCCATTTATTTTTC -> AATAGCCATTTATTTTTCC
AATGCGTCAGAGAGAGCGC -> ATGCGTCAGAGAGAGCGCT
CGCTACTCTCATCGGCCCT -> GCTACTCTCATCGGCCCTA
CGCCCAACTAACCAGCTAC -> GCCCAACTAACCAGCTACC
ACGGATCTGGAAATCTTCT -> CGGATCTGGAAATCTTCTG
AGCGTTACGATAGGAGACG -> GCGTTACGATAGGAGACGC
AATACAAAGGAAACGATTC -> ATACAAAGGAAACGATTCT
CAATCCTTCCTGCAGCGCT -> AATCCTTCCTGCAGCGCTG
CGGAGATAGCGTGACTTGT -> GGAGATAGCGTGACTTGTT
CCAGTATATGATTTCATTC -> CAGTATATGATTTCATTCC
TCTGCTGATCGAATAGTAC -> CTGCTGATCGAATAGTACA
ACAATCCTTCCTGCAGCGC -> CAATCCTTCCTGCAGCGCT
CGTAATTGGATTCTCGAAG -> GTAATTGGATTCTCGAAGC
ATTTATTTTTCCACATTAT -> TTTATTTTTCCACATTATG
GCCTTACTACAACAGACCG -> CCTTACTACAACAGACCGC
TCCAATAATGAGAACACAA -> CCAATAATGAGAACACAAT
CACGCAGTCTGCGATTGTA -> ACGCAGTCTGCGATTGTAT
GTGATGGTCCACTAGCTAC -> TGATGGTCCACTAGCTACA
TTTCATATCCTAAGACGCA -> TTCATATCCTAAGACGCAC
TGGATGTTATCGCATCAGT -> GGATGTTATCGCATCAGTT
TATCCGTCCCGCCCGTGTT -> ATCCGTCCCGCCCGTGTTG
AATTCGAATGTCCGCTCCG -> ATTCGAATGTCCGCTCCGG
TGTCTCACGCAGTCTGCGA -> GTCTCACGCAGTCTGCGAT
ACAGCCAGTGAGCAGGTTC -> CAGCCAGTGAGCAGGTTCG
GACCCGTACTTGATAACAC -> ACCCGTACTTGATAACACT
CCTGAGATTCTGCCCTGAC -> CTGAGATTCTGCCCTGACC
GTCTGCTGATCGAATAGTA -> TCTGCTGATCGAATAGTAC
ATCCCCGTAATTGGATTCT -> TCCCCGTAATTGGATTCTC
CCGTCCCGCCCGTGTTGGC -> CGTCCCGCCCGTGTTGGCA
CCTAAGGACCAATCCTCAC -> CTAAGGACCAATCCTCACT
TTAAATTGAGGTATCCGTC -> TAAATTGAGGTATCCGTCC
ACCATCTATTGTTAAATTG -> CCATCTATTGTTAAATTGA
CACCAACCTAAGGACCAAT -> ACCAACCTAAGGACCAATC
TTATCGACGTGTAACCGTT -> TATCGACGTGTAACCGTTG
CCAACCTAAGGACCAATCC -> CAACCTAAGGACCAATCCT
TCTGTACCCCCATGATCCT -> CTGTACCCCCATGATCCTT
AGATCCAATCGCTGTACAC -> GATCCAATCGCTGTACACA
TTTTACCTAGCTAGCCGGT -> TTTACCTAGCTAGCCGGTG
ACTACACTTCCATCAATGT -> CTACACTTCCATCAATGTC
AATGGATGTTATCGCATCA -> ATGGATGTTATCGCATCAG
GTTACCGAATAAATTGACC -> TTACCGAATAAATTGACCA
ATCCGTCCCGCCCGTGTTG -> TCCGTCCCGCCCGTGTTGG
ATTGTTAAATTGAGGTATC -> TTGTTAAATTGAGGTATCC
GAGCAGCGTGCCGTTATGT -> AGCAGCGTGCCGTTATGTA
GGAAATCTTCTGTGGGCGG -> GAAATCTTCTGTGGGCGGC
CCATGCTGGGCGTGAAATT -> CATGCTGGGCGTGAAATTA
CAACAGACCGCACCGTTTG -> AACAGACCGCACCGTTTGG
TTCTCTCGTGGTTCCATCC -> TCTCTCGTGGTTCCATCCA
ACGCACTTCTGAATCCGCG -> CGCACTTCTGAATCCGCGC
ATTCTGCCCTGACCCAATT -> TTCTGCCCTGACCCAATTG
AGGAACTACACTTCCATCA -> GGAACTACACTTCCATCAA
CCTCCTCCCCTCTATTGCC -> CTCCTCCCCTCTATTGCCG
TTTGGGCCTATAATACGTT -> TTGGGCCTATAATACGTTA
ACAGGAGGAACCTGGGGAT -> CAGGAGGAACCTGGGGATC
AAGATTCACACCGCGATTC -> AGATTCACACCGCGATTCT
GTCGATTGTCCTTCATCCA -> TCGATTGTCCTTCATCCAC
CGCACAGCCAGTGAGCAGG -> GCACAGCCAGTGAGCAGGT
